name,url,stars,description,license,question_issues,help_wanted_issues,total_issues,community_score,created_at
remittor/zapret-openwrt,https://github.com/remittor/zapret-openwrt,232,OpenWrt packages of https://github.com/bol-van/zapret,The MIT License,13,14,36,27,2024-10-10
jparkerweb/pixel-banner,https://github.com/jparkerweb/pixel-banner,92,🚩 Plugin for Obsidian that allows you to automatically add beautiful banner images to your notes from various sources.,The MIT License,21,2,14,23,2024-09-03
Groverio/To-Do-List,https://github.com/Groverio/To-Do-List,50,"A simple and intuitive To-Do List application to manage your tasks effectively. Features include task creation, editing, deletion.",The MIT License,1,10,48,11,2024-07-15
Luson045/medi-connect,https://github.com/Luson045/medi-connect,46,"Medi-connect(now Med Space)  is an online hospital appointment booking website. Visit our website,  Make sure the check the announcement... LEAVE US A ⭐...",The MIT License,0,10,101,10,2024-09-05
mathe00/obsidian-plugin-python-bridge,https://github.com/mathe00/obsidian-plugin-python-bridge,50,"Develop Obsidian plugins in Python! 🐍 Interact with your notes, retrieve frontmatter, send notifications, and much more – all through simple Python scripts. Cut the complexity of writing JavaScript plugins and dive into creating your Obsidian workflows with Python!",The MIT License,1,9,12,10,2024-09-29
avo-hq/marksmith,https://github.com/avo-hq/marksmith,391,GitHub-style markdown editor for Ruby and Rails,The MIT License,0,7,7,7,2025-01-19
kaiban-ai/KaibanJS,https://github.com/kaiban-ai/KaibanJS,989,KaibanJS is a JavaScript-native framework for building and managing multi-agent systems  with a Kanban-inspired approach.,The MIT License,0,6,65,6,2024-07-10
manikumarreddyu/AgroTech-AI,https://github.com/manikumarreddyu/AgroTech-AI,74,AgroTech AI platform is a comprehensive web-based tool where users can access various machine learning models for making accurate predictions related to agriculture,The MIT License,0,6,0,6,2024-07-04
Vin205/Enyanjyoti,https://github.com/Vin205/Enyanjyoti,48,"This repository is officially part of GirlScript Summer of Code 2024 Extended Edition!  Enyanjyoti platform serves as a one stop solution for conceptual learning, career and employment opportunities and information about loans and grants",The MIT License,4,1,133,5,2024-09-18
Pedro-Gregorio/TubeMod,https://github.com/Pedro-Gregorio/TubeMod,290,A browser extension that allows users to visualize YouTube the way they want.,The MIT License,1,4,28,5,2024-09-11
farhan0167/otto-m8,https://github.com/farhan0167/otto-m8,63,"Flowchart-like UI to interconnect LLM's and Huggingface models, and deploy them as a REST API with little to no code.",Apache License 2.0,0,5,15,5,2024-09-10
RamakrushnaBiswal/PlayCafe,https://github.com/RamakrushnaBiswal/PlayCafe,51,it a cafe website🚀,The MIT License,4,0,43,4,2024-09-16
MarSeventh/CloudFlare-ImgBed,https://github.com/MarSeventh/CloudFlare-ImgBed,1550,基于 CloudFlare Pages 的开源文件托管解决方案，支持 Telegram Bot 、R2、S3 等多种存储方式！,Creative Commons 1.0 Universal,1,3,24,4,2024-07-19
guobao2333/DeepLX-Serverless,https://github.com/guobao2333/DeepLX-Serverless,489,DeepL Free API for Serverless,The MIT License,0,4,2,4,2024-08-08
codeaashu/DevDisplay,https://github.com/codeaashu/DevDisplay,228,"DevDisplay is a global open source community platform that brings together all your tech needs in one place. 🌟 Join DevDisplay to Showcase your skills, connect globally, collaborate, build and promote.",The MIT License,0,3,51,3,2024-09-13
BYOJS/storage,https://github.com/BYOJS/storage,221,Simple key-value storage API backed by various client storage mechanisms,The MIT License,1,2,2,3,2024-08-26
urin/vscode-web-visual-editor,https://github.com/urin/vscode-web-visual-editor,587,Edit HTML files visually.,The MIT License,2,1,0,3,2024-08-19
daxcay/ComfyUI-Nexus,https://github.com/daxcay/ComfyUI-Nexus,80,Node to enable seamless multiuser workflow collaboration,The MIT License,3,0,0,3,2024-08-24
modelcontextprotocol/servers,https://github.com/modelcontextprotocol/servers,9559,Model Context Protocol Servers,The MIT License,1,1,144,2,2024-11-19
KwokKwok/Silo,https://github.com/KwokKwok/Silo,210,"多模型同时对话、文生图，纯前端。Multi-model simultaneous chat、text-to-image generation, all done through pure front-end (API mode, no server-side needed).",The MIT License,0,2,0,2,2024-08-20
vedhsaka/Nothotdog-mvp,https://github.com/vedhsaka/Nothotdog-mvp,62,NotHotDog is postman for voice AI agents,The MIT License,0,1,23,1,2024-07-23
setube/vue-XiuXianGame,https://github.com/setube/vue-XiuXianGame,1128,文字游戏: 我的文字修仙全靠刷,The MIT License,1,0,6,1,2024-07-14
roboflow/model-leaderboard,https://github.com/roboflow/model-leaderboard,63,Which model is the best at object detection? Which is best for small or large objects? We compare the results in a handy leaderboard.,The MIT License,1,0,6,1,2024-09-03
weapp-vite/weapp-vite,https://github.com/weapp-vite/weapp-vite,80,weapp-vite 把现代化的 web 开发方式，带入传统的小程序开发吧！,The MIT License,1,0,3,1,2024-09-18
mylofi/local-vault,https://github.com/mylofi/local-vault,109,"Store key-value data encrypted (biometric passkey protected), locally in the client",The MIT License,0,1,2,1,2024-08-12
ViaAnthroposBenevolentia/gemini-2-live-api-demo,https://github.com/ViaAnthroposBenevolentia/gemini-2-live-api-demo,287,"Vanilla JS web interface for Gemini 2.0 flash-exp  Multimodal API with text, audio, camera, screen inputs and audio responses and function calling",The MIT License,0,1,1,1,2024-12-20
RootUp/SmuggleShield,https://github.com/RootUp/SmuggleShield,87,Protection against HTML smuggling attempts.,Apache License 2.0,0,1,1,1,2024-09-13
lauritzh/dead-domain-discovery,https://github.com/lauritzh/dead-domain-discovery,48,"This Chromium extension scans the page for external iFrames, Scripts, and Styles, logs them to the console, and checks if their domains are resolvable.",Apache License 2.0,0,1,1,1,2024-10-08
agnilondapakou/helloWorld,https://github.com/agnilondapakou/helloWorld,45,Hello world is an Open Source project for programming beginners. It consists in providing a program that returns the “Hello World” message in the programming language you know.,The MIT License,0,0,613,0,2024-10-02
strivedi4u/hacktoberfest2024,https://github.com/strivedi4u/hacktoberfest2024,72,"This repository is for beginners who want to contribution in open source Hacktoberfest 2024.This project is designed to promote learning and growth in the field of software development. It offers a range of coding challenges and projects that cover various topics, from basic algorithms to complex application development.",Apache License 2.0,0,0,218,0,2024-10-01
gnmyt/Nexterm,https://github.com/gnmyt/Nexterm,2650,"The open source server management software for SSH, VNC & RDP",The MIT License,0,0,87,0,2024-08-13
openai/openai-realtime-api-beta,https://github.com/openai/openai-realtime-api-beta,862,Node.js + JavaScript reference client for the Realtime API (beta),The MIT License,0,0,78,0,2024-09-30
6Kmfi6HP/EDtunnel,https://github.com/6Kmfi6HP/EDtunnel,1846,"EDtunnel 是一个基于 Cloudflare Workers 和 Pages 的代理工具，支持多种协议和配置选项。  EDtunnel is a proxy tool based on Cloudflare Workers and Pages, supporting multiple protocols and configuration options.",The MIT License,0,0,66,0,2024-09-11
openai/openai-realtime-console,https://github.com/openai/openai-realtime-console,2911,"React app for inspecting, building and debugging with the Realtime API",The MIT License,0,0,48,0,2024-09-30
chrisgoringe/cg-controller,https://github.com/chrisgoringe/cg-controller,58,,The MIT License,0,0,45,0,2024-09-30
InternLM/MindSearch,https://github.com/InternLM/MindSearch,6029,🔍 An LLM-based Multi-agent Framework of Web Search Engine (like Perplexity.ai Pro and SearchGPT),Apache License 2.0,0,0,41,0,2024-07-28
ivysone/Will-you-be-my-Valentine-,https://github.com/ivysone/Will-you-be-my-Valentine-,374,"A simple interactive webpage built using HTML, CSS, and JavaScript.",The MIT License,0,0,38,0,2025-01-31
SamarthTech/web-projects-2024,https://github.com/SamarthTech/web-projects-2024,73,This is the Official Repository of SAMARTH for Open-Odyssey 1.0. Contribute your Web Development or Applications in our Repository 🔥. Make Quality Contributions 😎,The MIT License,0,0,32,0,2024-09-25
EddieHubCommunity/HealthCheck,https://github.com/EddieHubCommunity/HealthCheck,75,Checks how friendly your Open Source project is and suggests improvements! Sponsored by @Flagsmith,The MIT License,0,0,31,0,2024-07-07
hexgrad/kokoro,https://github.com/hexgrad/kokoro,1144,https://hf.co/hexgrad/Kokoro-82M,Apache License 2.0,0,0,30,0,2025-01-10
Toxic1239/Zenon_Crash,https://github.com/Toxic1239/Zenon_Crash,151,Zenon Bug Bot Made By Toxxic Boy,Apache License 2.0,0,0,30,0,2024-07-19
sunzsh/internal-chat,https://github.com/sunzsh/internal-chat,563,纯html写的局域网文字/文件p2p传输工具,The MIT License,0,0,28,0,2024-12-14
PatrickJS/everyone-ssn-usa,https://github.com/PatrickJS/everyone-ssn-usa,317,releasing everyone's SSN and the hacks used to acquire them ,The MIT License,0,0,28,0,2024-08-15
Bot-hostin/DRK-RAGNA-1.0,https://github.com/Bot-hostin/DRK-RAGNA-1.0,73,new whatsapp box efficient powerful with all active commands 100% free leave a like if you liked it...,The MIT License,0,0,27,0,2024-11-13
groovelauncher/GrooveLauncher,https://github.com/groovelauncher/GrooveLauncher,148,A groovy personalized home screen experience for Android,The MIT License,0,0,25,0,2024-08-06
dante4rt/nodepay-airdrop-bot,https://github.com/dante4rt/nodepay-airdrop-bot,115,"A bot for automating Nodepay airdrop interactions, including session management and pinging with proxy support.",The MIT License,0,0,23,0,2024-11-10
bitrix-tools/b24-rest-docs,https://github.com/bitrix-tools/b24-rest-docs,52,"Полная документация по REST API  Битрикс24, разработке приложений и интеграций",The MIT License,0,0,23,0,2024-08-16
7Sageer/sublink-worker,https://github.com/7Sageer/sublink-worker,1586,无需服务器，一键部署，快速使用自建节点分享URL进行订阅转换，提供灵活的自定义选项，支持SingBox/Clash/V2Ray/Xray,The MIT License,0,0,22,0,2024-07-27
erosDiffusion/ComfyUI-enricos-nodes,https://github.com/erosDiffusion/ComfyUI-enricos-nodes,369,Compositor Node experiments,The MIT License,0,0,20,0,2024-08-20
Toxic1239/RIASGREMORYBOT,https://github.com/Toxic1239/RIASGREMORYBOT,235,WhatsApp Bot Made By Toxxic Tech,Apache License 2.0,0,0,20,0,2024-07-05
BADBOI-v1/BADBOI-v2,https://github.com/BADBOI-v1/BADBOI-v2,59,A WhatsApp bot made with up-to-date technology and scientific insights by BADBOI  MD,Apache License 2.0,0,0,18,0,2024-07-12
dante4rt/blum-airdrop-bot,https://github.com/dante4rt/blum-airdrop-bot,143,"Automates interactions with the Blum airdrop platform, including claiming rewards, managing farming sessions, completing tasks, and playing games.",The MIT License,0,0,17,0,2024-08-15
fetchfox/fetchfox,https://github.com/fetchfox/fetchfox,125,,The MIT License,0,0,17,0,2024-08-28
Zlkcyber/LedgeBot,https://github.com/Zlkcyber/LedgeBot,88,layeredge auto run node - support multy accounts - support proxy usage - auto referral,The MIT License,0,0,17,0,2025-01-24
google-gemini/example-chat-app,https://github.com/google-gemini/example-chat-app,65,Get up and running with the Gemini API using Node.js and Python,Apache License 2.0,0,0,17,0,2024-09-04
banocean/ifv,https://github.com/banocean/ifv,45,Browser extension with improvements for eduVULCAN and Dziennik VULCAN,The MIT License,0,0,17,0,2024-08-27
xinnan-tech/xiaozhi-esp32-server,https://github.com/xinnan-tech/xiaozhi-esp32-server,511,"本项目为xiaozhi-esp32提供后端服务，帮助您快速搭建ESP32设备控制服务器。Backend service for xiaozhi-esp32, helps you quickly build an ESP32 device control server.",The MIT License,0,0,16,0,2025-02-02
tech-shrimp/gemini-playground,https://github.com/tech-shrimp/gemini-playground,507,"Deploy a Gemini multimodal chat website in 10 seconds, Severless!         只需准备一个Gemini API Key，10秒即可部署一个Gemini多模态对话的网站。",The MIT License,0,0,16,0,2025-01-03
hotwired/spark,https://github.com/hotwired/spark,349,Hot reloading for Hotwire,The MIT License,0,0,16,0,2024-11-23
es-tooling/module-replacements-codemods,https://github.com/es-tooling/module-replacements-codemods,190,,The MIT License,0,0,15,0,2024-07-17
Zlkcyber/oasis-bot,https://github.com/Zlkcyber/oasis-bot,68,oasis ai bot auto create multiple providers and send hearbeat every minutes,The MIT License,0,0,15,0,2024-12-02
easychen/ai-rss,https://github.com/easychen/ai-rss,164,AI时代的RSS生成器,The MIT License,0,0,14,0,2024-12-22
microsoft/cloudcloak,https://github.com/microsoft/cloudcloak,93,A hackathon idea to hide sensitive information in the Azure Portal,The MIT License,0,0,14,0,2024-09-12
huggingface/transformers.js-examples,https://github.com/huggingface/transformers.js-examples,1275,A collection of 🤗 Transformers.js demos and example applications,Apache License 2.0,0,0,13,0,2024-08-12
web3bothub/gradient-bot,https://github.com/web3bothub/gradient-bot,103,https://app.gradient.network/signup?code=EK8G9A,The MIT License,0,0,13,0,2024-09-18
mikoshu/gewechaty,https://github.com/mikoshu/gewechaty,189,GeweBot是基于Gewechat项目的二次封装，提供了更方便的使用方式。它参考wechaty的api实现，以满足更快速开发的需求。,The MIT License,0,0,12,0,2024-09-25
lizhipay/mcy-shop,https://github.com/lizhipay/mcy-shop,138,纯原生PHP打造一款极具潜力的个人创业型商城系统，支持虚拟商品，实体商品，任意支付方式！,The MIT License,0,0,12,0,2024-10-13
springreport/springreport,https://github.com/springreport/springreport,195,SpringReport是一款企业级的报表系统，支持在线设计报表，并绑定动态数据源，无需写代码即可快速生成想要的报表，可以支持excel报表和word报表两种格式，同时还可以支持excel多人协同编辑,Apache License 2.0,0,0,11,0,2024-07-14
alamshafil/auto-shorts,https://github.com/alamshafil/auto-shorts,157,AutoShorts can generate short videos with the help of AI. It can generate popular types of video seen on YouTube Shorts and TikTok.,The MIT License,0,0,11,0,2024-07-31
leo4life2/MinePal,https://github.com/leo4life2/MinePal,116,AI friend that you can talk to and play with in Minecraft.,The MIT License,0,0,11,0,2024-07-07
Toxic1239/Queen-RiasV3_,https://github.com/Toxic1239/Queen-RiasV3_,67,,The MIT License,0,0,11,0,2025-01-09
nolenroyalty/every-uuid,https://github.com/nolenroyalty/every-uuid,512,in case I forget one,The MIT License,0,0,10,0,2024-12-02
addyosmani/git2txt,https://github.com/addyosmani/git2txt,456,CLI tool to convert GitHub repositories to text files for LLMs,The MIT License,0,0,10,0,2024-11-21
DeepLifeStudio/DeepSeekAI,https://github.com/DeepLifeStudio/DeepSeekAI,354,Browser extension for invoking the DeepSeek AI large model.,The MIT License,0,0,10,0,2024-08-21
dante4rt/t3rn-airdrop-bot,https://github.com/dante4rt/t3rn-airdrop-bot,169,A bot for automating transactions and bridging assets on the t3rn network.,The MIT License,0,0,10,0,2024-09-01
eslint/css,https://github.com/eslint/css,167,CSS language plugin for ESLint,Apache License 2.0,0,0,10,0,2024-10-25
robertvoy/ComfyUI-Flux-Continuum,https://github.com/robertvoy/ComfyUI-Flux-Continuum,127,A modular workflow for FLUX inside of ComfyUI that brings order to the chaos of image generation pipelines.,The MIT License,0,0,10,0,2024-10-14
platformatic/ssr-performance-showdown,https://github.com/platformatic/ssr-performance-showdown,99,Let's evaluate the performance of SSR libraries,Apache License 2.0,0,0,10,0,2024-08-19
Zlkcyber/teneo-farm,https://github.com/Zlkcyber/teneo-farm,61,"Running Teneo Node BETA, CLI Version, Teneo Is an Browser extension Node Based.",The MIT License,0,0,10,0,2024-10-29
Zlkcyber/litasBot,https://github.com/Zlkcyber/litasBot,51,auto claim and auto start mining for litas -- support proxy usage -- support multy accounts,The MIT License,0,0,10,0,2025-01-16
clusterzx/paperless-ai,https://github.com/clusterzx/paperless-ai,2108,"An automated document analyzer for Paperless-ngx using OpenAI API, Ollama and all OpenAI API compatible Services to automatically analyze and tag your documents.",The MIT License,0,0,9,0,2024-12-01
arthurfiorette/proposal-try-operator,https://github.com/arthurfiorette/proposal-try-operator,1684,Draft for ECMAScript Error Safe Assignment Operator,The MIT License,0,0,9,0,2024-08-12
dimdenGD/ultimate-express,https://github.com/dimdenGD/ultimate-express,575,"The Ultimate Express. Fastest http server with full Express compatibility, based on µWebSockets.",Apache License 2.0,0,0,9,0,2024-09-08
need4swede/Portall,https://github.com/need4swede/Portall,416,Port Management Interface,The MIT License,0,0,9,0,2024-07-07
humanwhocodes/mentoss,https://github.com/humanwhocodes/mentoss,147,The best way to mock JavaScript fetch requests,Apache License 2.0,0,0,9,0,2025-01-22
11ty/eleventy-import,https://github.com/11ty/eleventy-import,98,"Utility to import content from multiple services (and a CLI, too)",The MIT License,0,0,9,0,2024-11-07
kingmalvn/MALVIN-XD,https://github.com/kingmalvn/MALVIN-XD,83,MALVIN XD Whatsapp Bot | World Best Whatsapp Bot | Made In Zimbabwe ,Apache License 2.0,0,0,9,0,2025-01-25
Zlkcyber/opledBot,https://github.com/Zlkcyber/opledBot,62,auto connect and send heartbeat for openledger - support multy accounts - support proxy usage - auto claim daily reward,The MIT License,0,0,9,0,2025-01-10
dante4rt/plume-testnet-bot,https://github.com/dante4rt/plume-testnet-bot,58,A bot for interacting with the Plume Testnet faucet and managing transactions automatically.,The MIT License,0,0,9,0,2024-07-17
abinthomasonline/repo2txt,https://github.com/abinthomasonline/repo2txt,1120,Web-based tool converts GitHub repository contents into a single formatted text file,The MIT License,0,0,8,0,2024-09-23
eimg/rsd25,https://github.com/eimg/rsd25,383,Rockstar Developer 2025 - Book and Source Code,The MIT License,0,0,8,0,2024-07-16
anaisbetts/mcp-installer,https://github.com/anaisbetts/mcp-installer,320,An MCP server that installs other MCP servers for you,The MIT License,0,0,8,0,2024-11-26
dh1011/subscription-manager,https://github.com/dh1011/subscription-manager,181,A simple web app to help you keep track of your subscriptions and manage your expenses.,The MIT License,0,0,8,0,2024-09-27
JetBrains/mcp-jetbrains,https://github.com/JetBrains/mcp-jetbrains,88,"A model context protocol server to work with JetBrains IDEs: IntelliJ, PyCharm, WebStorm, etc. Also, works with Android Studio",Apache License 2.0,0,0,8,0,2024-12-09
cierru/st-stepped-thinking,https://github.com/cierru/st-stepped-thinking,79,An extension for SillyTavern that lets characters think before responding,The MIT License,0,0,8,0,2024-10-11
humanwhocodes/crosspost,https://github.com/humanwhocodes/crosspost,76,A JavaScript utility for posting across multiple social networks at once,Apache License 2.0,0,0,8,0,2024-11-08
Zlkcyber/haustBot,https://github.com/Zlkcyber/haustBot,75,HAUST AUTO CLAIM FAUCET,The MIT License,0,0,8,0,2025-01-01
krasch/trans-europe-planner,https://github.com/krasch/trans-europe-planner,61,Making it simpler to plan cross-country rail trips in Europe,The MIT License,0,0,8,0,2024-09-04
alloy-framework/alloy,https://github.com/alloy-framework/alloy,55,A code generation framework inspired by JavaScript front-end frameworks,The MIT License,0,0,8,0,2024-07-16
phaserjs/phaser-box2d,https://github.com/phaserjs/phaser-box2d,54,"A high-performance, industry-standard 2D physics engine built on Box2D v3, delivering incredibly realistic and engaging web game experiences.",The MIT License,0,0,8,0,2024-12-23
abhiz123/todoist-mcp-server,https://github.com/abhiz123/todoist-mcp-server,52,MCP server for Todoist integration enabling natural language task management with Claude,The MIT License,0,0,8,0,2024-12-03
EMMYHENZ-TECH/EMMY-HENZ-V3,https://github.com/EMMYHENZ-TECH/EMMY-HENZ-V3,52,,Apache License 2.0,0,0,8,0,2024-09-30
mzxrai/mcp-webresearch,https://github.com/mzxrai/mcp-webresearch,154,MCP web research server (give Claude real-time info from the web),The MIT License,0,0,7,0,2024-12-06
LuckyPuppy514/external-player,https://github.com/LuckyPuppy514/external-player,84,Play web video via external player,The MIT License,0,0,7,0,2024-11-24
airdropinsiders/LayerEdge-Auto-Bot,https://github.com/airdropinsiders/LayerEdge-Auto-Bot,77,,The MIT License,0,0,7,0,2025-01-26
Zlkcyber/depinedBot,https://github.com/Zlkcyber/depinedBot,62,Depined Auto Ping and Auto Register/Auto Referral,The MIT License,0,0,7,0,2025-01-13
airdropinsiders/Mango-Testnet-Auto-Bot,https://github.com/airdropinsiders/Mango-Testnet-Auto-Bot,61,,The MIT License,0,0,7,0,2025-01-05
Zlkcyber/plazafintot,https://github.com/Zlkcyber/plazafintot,59,Plaza Finance Testnet -- auto daily deposit and withdraw -- auto get faucet -- auto create new wallets -- support proxy,The MIT License,0,0,7,0,2024-12-18
qiayue/GitBase,https://github.com/qiayue/GitBase,663,Github Based Simple Website Framework,The MIT License,0,0,6,0,2024-08-10
texel-org/color,https://github.com/texel-org/color,437,"modern color library for image processing and creative coding (oklab, xyz, p3, rec2020 + more)",The MIT License,0,0,6,0,2024-07-30
wire-elements/wire-spy,https://github.com/wire-elements/wire-spy,427,WireSpy—a sleek new debug bar for Livewire,The MIT License,0,0,6,0,2024-09-01
twilio-samples/speech-assistant-openai-realtime-api-node,https://github.com/twilio-samples/speech-assistant-openai-realtime-api-node,253,,The MIT License,0,0,6,0,2024-09-25
AZHenley/Mirror,https://github.com/AZHenley/Mirror,193,An LLM-powered programming-by-example programming language.,The MIT License,0,0,6,0,2024-10-13
brycebostwick/FixTheGulf,https://github.com/brycebostwick/FixTheGulf,144,A Chrome extension that restores the Gulf of Mexico's name,The MIT License,0,0,6,0,2025-02-16
Zlkcyber/openloop,https://github.com/Zlkcyber/openloop,67,openloop bot auto reff and auto ping,The MIT License,0,0,6,0,2024-11-29
ScriptedAlchemy/rsnext,https://github.com/ScriptedAlchemy/rsnext,57,,The MIT License,0,0,6,0,2024-07-19
paskito002/STINGER-V4,https://github.com/paskito002/STINGER-V4,49,"This is ES TEAMS BUG, A Whatsapp Bot Built by ES TEAMS TECH, Enhanced with Amazing Features to Make Your Whatsapp Communication and Interaction Experience Amazing",Apache License 2.0,0,0,6,0,2024-10-24
Zlkcyber/arichain,https://github.com/Zlkcyber/arichain,45,auto register/reff for arichain ,The MIT License,0,0,6,0,2025-01-19
run-llama/voice-chat-pdf,https://github.com/run-llama/voice-chat-pdf,314,Use OpenAI's realtime API for a chatting with your documents,The MIT License,0,0,5,0,2024-10-04
burakorkmez/mern-ecommerce,https://github.com/burakorkmez/mern-ecommerce,303,,The MIT License,0,0,5,0,2024-08-27
upward-spiral-research/world-interface,https://github.com/upward-spiral-research/world-interface,162,A simulated operating system design for AI Agents to interact with the world,The MIT License,0,0,5,0,2024-10-03
DannyTech20/CREEPY_MD-V1,https://github.com/DannyTech20/CREEPY_MD-V1,112,,Apache License 2.0,0,0,5,0,2024-11-28
wh3at/n8n-folder-view,https://github.com/wh3at/n8n-folder-view,89,Adds a folder view to n8n sidebar based on tags.,The MIT License,0,0,5,0,2025-01-07
Zlkcyber/mygateBot,https://github.com/Zlkcyber/mygateBot,82,my-gate network Bot,The MIT License,0,0,5,0,2025-01-03
mateushsx/algorithms-js,https://github.com/mateushsx/algorithms-js,66,"📚 algorithms-js é um repositório repleto de algoritmos em JavaScript que estudei e implementei, perfeito para quem quer resolver problemas, aprimorar habilidades e colaborar com a comunidade! 🚀",The MIT License,0,0,5,0,2024-09-13
shelwinsunga/jules,https://github.com/shelwinsunga/jules,64,AI Powered LaTeX Editor. ,The MIT License,0,0,5,0,2024-08-19
pyroprompts/any-chat-completions-mcp,https://github.com/pyroprompts/any-chat-completions-mcp,63,,The MIT License,0,0,5,0,2024-12-02
Widiskel/not-pixel-bot,https://github.com/Widiskel/not-pixel-bot,54,"Not Pixel Bot with auto paint, auto claim mining, auto upgrade boost",The MIT License,0,0,5,0,2024-09-24
Widiskel/soniclabs-arcade-bot,https://github.com/Widiskel/soniclabs-arcade-bot,49,"Soniclabs Previously Phantom, Arcade Game BOT",The MIT License,0,0,5,0,2024-10-11
g0t4/mcp-server-commands,https://github.com/g0t4/mcp-server-commands,46,Model Context Protocol server to run commands,The MIT License,0,0,5,0,2024-11-29
jaywcjlove/free-font,https://github.com/jaywcjlove/free-font,2363,Collection of Free English/Chinese Fonts for Commercial Use. 收录可商用的免费英文/汉字字体。,The MIT License,0,0,4,0,2024-07-16
burakorkmez/fullstack-chat-app,https://github.com/burakorkmez/fullstack-chat-app,486,Real Time Chat App with Awesome UI,The MIT License,0,0,4,0,2024-11-18
cmliussss2024/CF-Workers-checkin,https://github.com/cmliussss2024/CF-Workers-checkin,170,签到,Apache License 2.0,0,0,4,0,2024-10-28
anshaneja5/mldl.study,https://github.com/anshaneja5/mldl.study,163,"ML & DL roadmap with curated resources like videos, articles, research-papers, competitions, projects etc.",The MIT License,0,0,4,0,2024-11-17
sshh12/spark-stack,https://github.com/sshh12/spark-stack,153,Spark Stack is an tool for building web applications through an AI-powered chat interface. Create quick MVPs and prototypes using natural language prompts.,The MIT License,0,0,4,0,2024-11-09
anaisbetts/mcp-youtube,https://github.com/anaisbetts/mcp-youtube,149,A Model-Context Protocol Server for YouTube,The MIT License,0,0,4,0,2024-11-19
AgentDeskAI/browser-tools-mcp,https://github.com/AgentDeskAI/browser-tools-mcp,127,Monitor browser logs directly from Cursor and other MCP compatible IDEs.,The MIT License,0,0,4,0,2025-02-10
suekou/mcp-notion-server,https://github.com/suekou/mcp-notion-server,108,,The MIT License,0,0,4,0,2024-11-30
yuchentime/xhs-tools-extension,https://github.com/yuchentime/xhs-tools-extension,99,小红书运营工具箱,The MIT License,0,0,4,0,2025-01-06
GlobalTechInfo/GLOBAL-MD,https://github.com/GlobalTechInfo/GLOBAL-MD,90,,The MIT License,0,0,4,0,2024-10-07
Nearcyan/BlueRaven,https://github.com/Nearcyan/BlueRaven,83,Twitter (sometimes known as X) can look prettier with this simple AddOn!,The MIT License,0,0,4,0,2025-01-25
serverless/containers,https://github.com/serverless/containers,75,A rich developer experience for deploying containers to AWS Lambda and AWS ECS Fargate – without rearchitecting.,The MIT License,0,0,4,0,2025-01-16
laure1102/lpanda,https://github.com/laure1102/lpanda,74,AI 小说生成推文漫画视频,The MIT License,0,0,4,0,2024-08-23
recitativonika/Dawn-Validator-bot,https://github.com/recitativonika/Dawn-Validator-bot,69,DAWN Validator Extension automatic claim,The MIT License,0,0,4,0,2024-10-13
daniela-hase/onvif-server,https://github.com/daniela-hase/onvif-server,66,Virtual Onvif Server - Add support for multichannel Onvif cameras to Unifi Protect!,The MIT License,0,0,4,0,2024-10-10
codematrixer/ui-viewer,https://github.com/codematrixer/ui-viewer,64,"UI hierarchy inspector for Mobile App, supporting Android, iOS, HarmonyOS NEXT.",The MIT License,0,0,4,0,2024-09-29
Zlkcyber/takerBot,https://github.com/Zlkcyber/takerBot,62,Taker Bot Auto Activate Daily Mining,The MIT License,0,0,4,0,2025-01-05
KOSASIH/PiWallet-Pro,https://github.com/KOSASIH/PiWallet-Pro,56,A Next-Generation Wallet for Pi Network,Apache License 2.0,0,0,4,0,2024-08-24
Zlkcyber/hiveraBot,https://github.com/Zlkcyber/hiveraBot,55,hivera miniApp bot auto mining,The MIT License,0,0,4,0,2024-12-16
gitsub66/3Kmfi6HP_EDtunnel_20240711,https://github.com/gitsub66/3Kmfi6HP_EDtunnel_20240711,54,,The MIT License,0,0,4,0,2024-07-11
Dev-AhmedRabby/solana-arbitrage-bot,https://github.com/Dev-AhmedRabby/solana-arbitrage-bot,53,Automated Arbitrage Bot Using Jupiter on Solana,The MIT License,0,0,4,0,2025-02-15
howoii/SmartBookmark,https://github.com/howoii/SmartBookmark,48,一款基于 AI 的智能书签管理插件,The MIT License,0,0,4,0,2025-01-10
JawadYTX/KHAN-MD,https://github.com/JawadYTX/KHAN-MD,48,,Apache License 2.0,0,0,4,0,2025-01-28
cmliu/CF-Workers-DD2D,https://github.com/cmliu/CF-Workers-DD2D,44,将多个域名IP解析至指定域名的worker.js定时脚本,Apache License 2.0,0,0,4,0,2024-07-13
zlwaterfield/scramble,https://github.com/zlwaterfield/scramble,1490,Open-Source Grammarly Alternative,The MIT License,0,0,3,0,2024-09-18
i-am-shodan/USBArmyKnife,https://github.com/i-am-shodan/USBArmyKnife,1185,USB Army Knife – the ultimate close access tool for penetration testers and red teamers.,The MIT License,0,0,3,0,2024-09-27
xzitlou/jsontr.ee,https://github.com/xzitlou/jsontr.ee,795,Effortlessly visualize JSON structures as dynamic tree diagrams,The MIT License,0,0,3,0,2024-11-25
ling-drag0n/CloudPaste,https://github.com/ling-drag0n/CloudPaste,457,基于 Cloudflare Workers 的在线剪贴板和文件分享服务，支持 Markdown、阅后即焚、文本/文件分享、密码保护等功能,The MIT License,0,0,3,0,2024-11-22
NousResearch/Open-Reasoning-Tasks,https://github.com/NousResearch/Open-Reasoning-Tasks,410,A comprehensive repository of reasoning tasks for LLMs (and beyond),Apache License 2.0,0,0,3,0,2024-07-22
78/xiaozhi,https://github.com/78/xiaozhi,350,Build your own AI friend,The MIT License,0,0,3,0,2024-08-31
carl24tech/Cyberion-Spark-X,https://github.com/carl24tech/Cyberion-Spark-X,265,"Cyberion-Spark-X is a dynamic WhatsApp bot designed to provide instant assistance and personalized services to users. It is equipped with advanced AI capabilities to understand and respond to queries, streamline tasks, and offer tailored recommendations. From automated responses to real-time updates, Cyberion-Spark-X is your virtual assistant.",The MIT License,0,0,3,0,2024-08-23
penjc/CityU,https://github.com/penjc/CityU,215,CityU 手册，一站式解锁课程信息和评价、校园生活攻略与就业资源。,The MIT License,0,0,3,0,2025-01-09
ansoncloud8/am-cf-tunnel,https://github.com/ansoncloud8/am-cf-tunnel,191,这是一个基于 Cloudflare Workers 和 Pages平台的脚本，在原版的基础上修改了显示 VLESS 配置信息转换为订阅内容。使用该脚本，你可以方便地将 VLESS、trojan 配置信息使用在线配置转换到 Clash、 Singbox 、Quantumult X等工具中。,Apache License 2.0,0,0,3,0,2024-07-31
DeeCeeXxx/Queen_Anita_V2,https://github.com/DeeCeeXxx/Queen_Anita_V2,161,,Apache License 2.0,0,0,3,0,2024-09-03
bilaltosungit/schengen-visa-appointment-bot,https://github.com/bilaltosungit/schengen-visa-appointment-bot,146,,The MIT License,0,0,3,0,2025-01-14
simonw/prompts-js,https://github.com/simonw/prompts-js,143,async alternatives to browser alert() and prompt() and confirm(),Apache License 2.0,0,0,3,0,2024-12-07
chenbimo/yidash,https://github.com/chenbimo/yidash,131,yidash（易大师）一万个JavaScript实用方法库。,The MIT License,0,0,3,0,2024-07-29
shaobeichen/gradient-theme,https://github.com/shaobeichen/gradient-theme,101,🌅 Multiple beautiful VSCode gradient themes. 多个漂亮的VSCode渐变主题。,The MIT License,0,0,3,0,2024-09-13
slevithan/oniguruma-to-es,https://github.com/slevithan/oniguruma-to-es,92,"Convert patterns from Oniguruma (the regex engine used by Ruby, TextMate grammars, etc.) to native JavaScript RegExp",The MIT License,0,0,3,0,2024-09-26
swkim101/cspapers.org,https://github.com/swkim101/cspapers.org,91,A search engine dedicated to CS conferences. It provides useful filters for conferences and year range.,The MIT License,0,0,3,0,2024-08-06
hamelsmu/claudesave,https://github.com/hamelsmu/claudesave,79,A Chrome extension that saves conversations with Claude to GitHubGists or your clipboard.,Apache License 2.0,0,0,3,0,2024-08-09
fatwang2/search1api-mcp,https://github.com/fatwang2/search1api-mcp,69,,The MIT License,0,0,3,0,2024-11-26
face-hh/darkaroo,https://github.com/face-hh/darkaroo,68,"A browser extension for getting ads everywhere. Be forced to watch YouTube ads *with your eyes opened*, have popups on every site, scam buttons in random corners, yell words to close ads, and more",Apache License 2.0,0,0,3,0,2024-11-23
jerhadf/linear-mcp-server,https://github.com/jerhadf/linear-mcp-server,66,A server that integrates Linear's project management system with the Model Context Protocol (MCP) to allow LLMs to interact with Linear.,The MIT License,0,0,3,0,2024-12-03
M3264/Kord-Ai,https://github.com/M3264/Kord-Ai,60,"Introducing Kord-Ai, A WhatsApp bot that automates interactions on WhatsApp by executing predefined commands or responding to user inputs. It can handle tasks like sending messages, sharing media, and managing group activities, offering convenience and efficiency for users and businesses.",The MIT License,0,0,3,0,2024-09-09
thedev-me/register,https://github.com/thedev-me/register,59,Get your free '{name}.thedev.me' domain,The MIT License,0,0,3,0,2024-07-11
qpd-v/mcp-ragdocs,https://github.com/qpd-v/mcp-ragdocs,57,,Apache License 2.0,0,0,3,0,2024-12-13
heycalebszn/bannerly,https://github.com/heycalebszn/bannerly,50,Get fully customizable social banner.,The MIT License,0,0,3,0,2024-12-11
open-nest-africa/open-nest-africa,https://github.com/open-nest-africa/open-nest-africa,49,"🌸 OpenNest Website – Your safe, inclusive hub for open-source beginners!  ",The MIT License,0,0,3,0,2024-10-16
pixqc/ziglist,https://github.com/pixqc/ziglist,49,Discover Zig projects and packages,The MIT License,0,0,3,0,2024-08-01
recitativonika/openledger-bot,https://github.com/recitativonika/openledger-bot,49,Openledger Bot is a simple tool designed to automate the node and daily reward claim interaction,The MIT License,0,0,3,0,2025-01-09
rdmistra/selfhost-dl,https://github.com/rdmistra/selfhost-dl,47,"SelfHost-DL is my project that lets users self-host a simple web downloader with minimal setup. Just run it with Node.js—no third-party services needed. Deploy the files, start the server, and download content easily. Perfect for a lightweight, self-managed solution.",Apache License 2.0,0,0,3,0,2025-02-10
The-King-Destroy/Yuki_Suou-Bot,https://github.com/The-King-Destroy/Yuki_Suou-Bot,46,"👋 ¡Hola! Bienvenido(a) al Repositorio Oficial de Yuki-Suou-Bot, Un Bot muy Prometedor en constante evolución, tiene Múltiples Funciones y Juegos. Esperamos que te Guste y nos Regales una Estrellita 🌟 me Ayudaría Muchísimo 😁.",The MIT License,0,0,3,0,2024-09-30
Zlkcyber/expchain,https://github.com/Zlkcyber/expchain,45,expchain testnet auto deploy contract and interact,The MIT License,0,0,3,0,2024-12-14
Alanrk/LazyCat-Bookmark-Cleaner,https://github.com/Alanrk/LazyCat-Bookmark-Cleaner,492,让书签管理变得轻松愉快！一只可爱的懒猫助手，帮你智能清理和整理浏览器书签。,The MIT License,0,0,2,0,2024-12-29
sindresorhus/nano-spawn,https://github.com/sindresorhus/nano-spawn,475,Tiny process execution for humans — a better child_process,The MIT License,0,0,2,0,2024-08-19
mem0ai/mem0-chrome-extension,https://github.com/mem0ai/mem0-chrome-extension,381,Claude Memory: Long-term memory for Claude,The MIT License,0,0,2,0,2024-08-27
nodejs/amaro,https://github.com/nodejs/amaro,355,Node.js TypeScript wrapper,The MIT License,0,0,2,0,2024-07-16
seadfeng/cloudflare-proxy-sites,https://github.com/seadfeng/cloudflare-proxy-sites,352,,The MIT License,0,0,2,0,2024-08-04
goshops-com/clipshare,https://github.com/goshops-com/clipshare,347,"An incredibly simple, open-source alternative to Loom that only requires S3-compatible storage—no servers needed",The MIT License,0,0,2,0,2024-08-21
QingJ01/123pan_unlock,https://github.com/QingJ01/123pan_unlock,331,基于油猴的123云盘解锁脚本，支持解锁123云盘下载功能,Apache License 2.0,0,0,2,0,2024-11-30
Crayon-Shinchan/AnyDressing,https://github.com/Crayon-Shinchan/AnyDressing,272,"Official implementation of ""AnyDressing: Customizable Multi-Garment Virtual Dressing via Latent Diffusion Models""",The MIT License,0,0,2,0,2024-12-02
oss-serverless/serverless,https://github.com/oss-serverless/serverless,198,Serverless Framework CLI v3 alternative,The MIT License,0,0,2,0,2024-09-15
ErSanSan233/prose-polish,https://github.com/ErSanSan233/prose-polish,196,📝 文档润色助手 | 基于 AI 的可视化文稿润色工具，支持提示词编辑、文本块编排和智能优化，让写作更轻松、更专业。,The MIT License,0,0,2,0,2025-01-29
mylofi/local-data-lock,https://github.com/mylofi/local-data-lock,132,Protect local-first app data with encryption/decryption key secured in Webauthn (biometric) passkey,The MIT License,0,0,2,0,2024-07-29
NomadicDaddy/htmx-debugger,https://github.com/NomadicDaddy/htmx-debugger,124,a browser extension (Chrome and Firefox) debugging tool for htmx applications,The MIT License,0,0,2,0,2024-10-01
Freedom-Guard/Freedom-Guard,https://github.com/Freedom-Guard/Freedom-Guard,107,"Freedom Guard is a vpn for access to free ineternet. +x; Freedom Plus, Freedom Browser, Freedom Warp, Freedom Vibe",The MIT License,0,0,2,0,2024-10-18
DaInfernalCoder/perplexity-mcp,https://github.com/DaInfernalCoder/perplexity-mcp,104,A Model Context Protocol (MCP) server for research and documentation assistance using Perplexity AI,The MIT License,0,0,2,0,2025-01-26
wfcz10086/AI-automatically-generates-novels,https://github.com/wfcz10086/AI-automatically-generates-novels,102,一个基于ai +提示词 的智能小说创作生产力工具， 已经有数百家工作室和个人作者通过该工具实现了快速、批量生成小说。 通过 AI 技术提升创作效率以及完善的提示词管理功能，实现智能拆书、智能生书名简介、正文润色、shift+L快捷词条 等效率提升20倍，让写作更轻松、更专业。现已升级到 v5.2。,Apache License 2.0,0,0,2,0,2024-12-04
socketteer/clooi,https://github.com/socketteer/clooi,101,command loom interface,The MIT License,0,0,2,0,2024-07-10
ansoncloud8/am-trojan,https://github.com/ansoncloud8/am-trojan,88,这是基于CF平台的脚本，部署Trojan 配置信息转换为订阅内容。可以方便地将 Trojan 节点配置信息转换到 Clash 或 Singbox 或Quantumult X等工具中。,Apache License 2.0,0,0,2,0,2024-07-16
ading2210/CVE-2024-6778-POC,https://github.com/ading2210/CVE-2024-6778-POC,88,"A POC exploit for CVE-2024-5836 and CVE-2024-6778, allowing for a sandbox escape from a Chrome extension. ",The MIT License,0,0,2,0,2024-09-10
Joker-Reincarnated/Toxic-MD,https://github.com/Joker-Reincarnated/Toxic-MD,82,"Toxic MD is a powerful WhatsApp crash and bug bot developed by Joker, designed for managing and automating various bot-related functions. Whether you're testing crash bugs or exploring custom bot configurations, this bot has you covered.",Apache License 2.0,0,0,2,0,2024-10-06
tingyusys/RaindropEcho,https://github.com/tingyusys/RaindropEcho,80,一个方便逆向人员进行渗透的 burp 插件,The MIT License,0,0,2,0,2024-09-03
modelcontextprotocol/create-typescript-server,https://github.com/modelcontextprotocol/create-typescript-server,77,CLI tool to create a new TypeScript MCP server,The MIT License,0,0,2,0,2024-11-18
Hosinoharu/SkipJSDebugger,https://github.com/Hosinoharu/SkipJSDebugger,73,"An experimental tool that can skip JavaScript debugger statement in Edge and Chrome, and have a self-defined debugger.",The MIT License,0,0,2,0,2024-09-13
codepo8/trimMiddle,https://github.com/codepo8/trimMiddle,71,,The MIT License,0,0,2,0,2025-01-03
recitativonika/teneo-bot,https://github.com/recitativonika/teneo-bot,70,Teneo bot is a simple tool designed to automate the node interaction.,The MIT License,0,0,2,0,2024-11-01
fenrir2608/goGreen,https://github.com/fenrir2608/goGreen,69,make your profile look like you've been hard at work... even if you haven't.,The MIT License,0,0,2,0,2024-08-20
Lesterpaintstheworld/kinos,https://github.com/Lesterpaintstheworld/kinos,67,A multi-agent engine for the UBC Agents,The MIT License,0,0,2,0,2024-11-26
ArchiveBox/abx-dl,https://github.com/ArchiveBox/abx-dl,63,"⬇️ A simple all-in-one CLI tool to download EVERYTHING from a URL (like youtube-dl/yt-dlp, forum-dl, gallery-dl, simpler ArchiveBox). 🎭 Uses headless Chrome to get HTML, JS, CSS, images/video/audio/subtitles, PDFs, screenshots, article text, git repos, and more...",The MIT License,0,0,2,0,2024-10-21
icholy/ContainerScript,https://github.com/icholy/ContainerScript,60,Firefox Addon for programmatically assigning URLs to containers.,The MIT License,0,0,2,0,2024-11-29
boniphace478/BONIPHACE-MD,https://github.com/boniphace478/BONIPHACE-MD,60,𝑅𝐸𝐺𝐴𝑅𝐷𝑆 𝐵𝑂𝑁𝐼𝑃𝐻𝐴𝐶𝐸 𝑇𝐸𝐴𝑀........,The MIT License,0,0,2,0,2024-08-03
LiberBinjio/GlobalTalk-Hub,https://github.com/LiberBinjio/GlobalTalk-Hub,60,GlobalTalk Hub is a place where you can chat without language barriers.   Here you can speak your native language freely to friends all over the world and will be understood by them easily. Have fun💕🎈🌭🍔,The MIT License,0,0,2,0,2024-07-26
Eliasar54/ansi-BOT-MD,https://github.com/Eliasar54/ansi-BOT-MD,58,"ʜᴏʟᴀ 👋 ʙɪᴇɴᴠᴇɴɪᴅᴏ 💫 ᴀʟ ʀᴇᴘᴏsɪᴛᴏʀɪᴏ ᴏғɪᴄɪᴀʟ ᴅᴇʟ ᴀɴsí-ʙᴏᴛ, ᴇs ᴜɴ ʙᴏᴛ ᴅᴇ ᴡʜᴀᴛsᴀᴘᴘ ғᴜɴᴄɪᴏɴᴀʟ ᴄᴏɴ ʟᴀ ᴠᴇʀsɪᴏɴ ᴍᴜʟᴛɪ-ᴅᴇᴠɪᴄᴇ, ᴀǫᴜɪ sᴇ ʀᴇᴀʟɪᴢᴀʀᴀɴ ᴀᴄᴛᴜʟɪᴢᴀᴄɪᴏɴᴇs, sɪ ᴛᴇ ᴀɢʀᴀᴅᴀ ᴇʟ ʙᴏᴛ ᴍᴇ ᴘᴜᴇᴅᴇ ʀᴇɢᴀʟᴀs ᴜɴᴀ 🌟?, ᴇsᴘᴇʀᴏ ᴛᴇ ɢᴜsᴛᴇ 🤗",The MIT License,0,0,2,0,2024-08-01
RiceRound/ComfyUI_CryptoCat,https://github.com/RiceRound/ComfyUI_CryptoCat,56,designed to simplify workflows while providing encryption protection for them.,The MIT License,0,0,2,0,2024-09-28
Widiskel/evm-tx-deployer-bot,https://github.com/Widiskel/evm-tx-deployer-bot,54,"The Evm Testnet Bot is a powerful tool designed for interacting with EVM-compatible test networks. This bot automates transaction processes daily. Provides a built-in smart contract deployment feature, making it an ideal solution for you to do your testnet airdrop.",The MIT License,0,0,2,0,2024-10-15
ameymane09/trash-view-on-maps,https://github.com/ameymane09/trash-view-on-maps,54,"A game where you find trash on Street View images, and nobody wins (except for the people who are responsible for fixing the issue)",The MIT License,0,0,2,0,2025-01-16
TomFrankly/notion-helper,https://github.com/TomFrankly/notion-helper,52,A library of functions for working more easily with the Notion API,The MIT License,0,0,2,0,2024-09-09
Diomar-s/Kakaroto-Bot-MD,https://github.com/Diomar-s/Kakaroto-Bot-MD,50,,The MIT License,0,0,2,0,2024-09-22
engineervix/cv,https://github.com/engineervix/cv,50,"Write your CV in Markdown and generate both a responsive web page and a professional PDF with minimal setup. Features modern tooling (Vite, Puppeteer), beautiful icons, and automated PDF generation via CI/CD. See example below 👇",The MIT License,0,0,2,0,2025-01-25
Widiskel/fraction-ai-bot,https://github.com/Widiskel/fraction-ai-bot,49,Fraction AI Testnet Bot,The MIT License,0,0,2,0,2025-01-22
laranatech/larana-js,https://github.com/laranatech/larana-js,48,JavaScript implementation of Larana philosophy. Experimental alternative UI framework,The MIT License,0,0,2,0,2024-07-08
tavily-ai/tavily-mcp,https://github.com/tavily-ai/tavily-mcp,47,,The MIT License,0,0,2,0,2025-01-27
lee-sihun/djmax-keyviewer,https://github.com/lee-sihun/djmax-keyviewer,45,🎹 Electron & React 키뷰어,The MIT License,0,0,2,0,2025-01-03
KOSASIH/pi-stable-revoluter-core,https://github.com/KOSASIH/pi-stable-revoluter-core,44,"The core repository for the PiStable project, designed to transform Pi Coin into a stablecoin pegged at $314.159.",The MIT License,0,0,2,0,2024-11-07
ShouChenICU/FastSend,https://github.com/ShouChenICU/FastSend,875,FastSend 是一个基于 WebRTC 技术的点对点文件传输工具，支持快速的目录同步和文件传输。通过浏览器即可实现安全、高效的文件共享。,The MIT License,0,0,1,0,2024-07-12
addyosmani/firew0rks,https://github.com/addyosmani/firew0rks,528,Fireworks in your terminal 🎆,The MIT License,0,0,1,0,2024-12-31
isboyjc/cursor-reset,https://github.com/isboyjc/cursor-reset,492,Cursor Trial Reset Tool,The MIT License,0,0,1,0,2024-12-26
HeyPuter/Oops.js,https://github.com/HeyPuter/Oops.js,479,🤭 Oops.js: Add powerful undo/redo capabilities to your app,The MIT License,0,0,1,0,2024-08-05
JLinMr/Mini-Cover,https://github.com/JLinMr/Mini-Cover,373,Mini-Cover：简洁的在线生成封面网站，专为博客、短视频、社交媒体等生成个性化封面,The MIT License,0,0,1,0,2024-08-25
pudongping/mp-vx-insight,https://github.com/pudongping/mp-vx-insight,341,微信公众号小助手，扩展了一键获取微信公众号文章封面图、全部文章、一键采集文章内容等功能。,The MIT License,0,0,1,0,2024-07-03
hexagoncircle/pixel-canvas,https://github.com/hexagoncircle/pixel-canvas,279,Web Component that applies a shimmering pixel background on element hover,The MIT License,0,0,1,0,2024-12-03
zacharyreese/DualQRCode,https://github.com/zacharyreese/DualQRCode,250,Two different URLs in one QR code,The MIT License,0,0,1,0,2025-01-24
sindresorhus/yocto-spinner,https://github.com/sindresorhus/yocto-spinner,215,Tiny terminal spinner,The MIT License,0,0,1,0,2024-08-25
jsebrech/plainvanilla,https://github.com/jsebrech/plainvanilla,207,A tutorial website for plain vanilla web development,The MIT License,0,0,1,0,2024-07-21
mumuy/gobang,https://github.com/mumuy/gobang,196,五子棋人机对战游戏 - 经典游戏开发样例_Gobang based on HTML5,The MIT License,0,0,1,0,2024-09-19
mmiscool/aiCoder,https://github.com/mmiscool/aiCoder,154,A tool to write JS libraries using AI. The first and only tool that is using ASTs to perform surgical changes to existing code files with out mangling the code.  https://aicoderproject.com/,The MIT License,0,0,1,0,2024-10-28
dante4rt/silent-protocol-bot,https://github.com/dante4rt/silent-protocol-bot,153,Automation bot for interacting with the Silent Protocol testnet.,The MIT License,0,0,1,0,2025-02-06
earthjasonlin/zzz-signal-search-export,https://github.com/earthjasonlin/zzz-signal-search-export,153,"📺导出绝区零调频记录，支持 UIGF-v4.0，支持所有服务器 | Export Zenless Zone Zero signal search hisory, supports UIGF-v4.0, supports all servers🧰",The MIT License,0,0,1,0,2024-07-17
hmjz100/123panYouthMember,https://github.com/hmjz100/123panYouthMember,143,123 云盘会员青春版 - 在 123 云盘超过 1GB 上限下载文件，显示身份信息为会员,The MIT License,0,0,1,0,2024-11-30
olivierloverde/gmail-agent,https://github.com/olivierloverde/gmail-agent,136,AI-based Telegram agent with memory that will help you reach inbox 0 in no time. ,The MIT License,0,0,1,0,2024-11-12
xKiian/cloudflare-jsd,https://github.com/xKiian/cloudflare-jsd,132,Bypass Cloudflare's /h/b/jsd challenge using 100% python,The MIT License,0,0,1,0,2025-01-30
DannyMoerkerke/basic-service-worker,https://github.com/DannyMoerkerke/basic-service-worker,131,A basic Service Worker to make your web app work offline,The MIT License,0,0,1,0,2024-09-05
supercorp-ai/supergateway,https://github.com/supercorp-ai/supergateway,130,Run MCP stdio servers over SSE and SSE over stdio. AI gateway.,The MIT License,0,0,1,0,2024-12-21
golanlevin/p5.plotSvg,https://github.com/golanlevin/p5.plotSvg,129,A p5.js library for exporting SVG files tailored for pen plotting. ,The MIT License,0,0,1,0,2024-11-19
5etools-mirror-3/5etools-src,https://github.com/5etools-mirror-3/5etools-src,126,A mirror.,The MIT License,0,0,1,0,2024-09-14
mendableai/firecrawl-mcp-server,https://github.com/mendableai/firecrawl-mcp-server,113,"FireCrawl MCP Server is a powerful web scraping integration for Claude and other LLMs. It provides JavaScript rendering, batch processing, and search capabilities through a Model Context Protocol (MCP) interface. Now with support for self-hosted instances and advanced features like parallel processing, automatic retries, and content filtering",The MIT License,0,0,1,0,2024-12-06
collidingScopes/ascii,https://github.com/collidingScopes/ascii,112,Turn videos into ASCII pixel art using js and html canvas,The MIT License,0,0,1,0,2024-08-12
dante4rt/evm-auto-transfer,https://github.com/dante4rt/evm-auto-transfer,109,Automate EVM transactions on testnets and mainnets with ease. Configure your network and handle multiple transfers effortlessly using this bot.,The MIT License,0,0,1,0,2024-08-30
doyensec/CSPTPlayground,https://github.com/doyensec/CSPTPlayground,104,CSPTPlayground is an open-source playground to find and exploit Client-Side Path Traversal (CSPT).,Apache License 2.0,0,0,1,0,2024-10-03
patorjk/subpixel-snake,https://github.com/patorjk/subpixel-snake,103,A game of Snake that uses subpixels.,The MIT License,0,0,1,0,2025-01-16
doxdk/deepseek-desktop,https://github.com/doxdk/deepseek-desktop,102,"A desktop version of DeepSeek, an AI-powered application that provides intelligent assistance and interaction. This application allows users to access DeepSeek's chat interface directly from their desktop, with support for local storage and cookies.",The MIT License,0,0,1,0,2025-01-25
AINativeLab/awesome-flux-ai,https://github.com/AINativeLab/awesome-flux-ai,98,"A curated list of awesome resources, tools, libraries, and applications related to Flux AI technology. This repository aims to be a comprehensive collection for developers, researchers, and enthusiasts interested in Flux AI.",The MIT License,0,0,1,0,2024-08-17
shuding/svg-shaders,https://github.com/shuding/svg-shaders,95,Composable SVG Shaders,The MIT License,0,0,1,0,2024-11-02
Mintplex-Labs/anythingllm-extension,https://github.com/Mintplex-Labs/anythingllm-extension,91,Browser extension for AnythingLLM Docker & Desktop application,The MIT License,0,0,1,0,2024-08-27
thecodedose/pastanation,https://github.com/thecodedose/pastanation,90,,The MIT License,0,0,1,0,2024-11-06
e2b-dev/mcp-server,https://github.com/e2b-dev/mcp-server,90,Giving Claude ability to run code with E2B via MCP (Model Context Protocol),Apache License 2.0,0,0,1,0,2024-12-01
newideas99/Deepseek-Thinking-Claude-3.5-Sonnet-CLINE-MCP,https://github.com/newideas99/Deepseek-Thinking-Claude-3.5-Sonnet-CLINE-MCP,84,"🧠 MCP server implementing RAT (Retrieval Augmented Thinking) - combines DeepSeek's reasoning with GPT-4/Claude/Mistral responses, maintaining conversation context between interactions.",The MIT License,0,0,1,0,2025-01-25
Rem01Gaming/net-switch,https://github.com/Rem01Gaming/net-switch,83,Magisk Module to isolate any app from Internet access,Apache License 2.0,0,0,1,0,2025-01-03
yitong2333/Bionic-Reading,https://github.com/yitong2333/Bionic-Reading,79,仿生阅读（Bionic Reading）的油猴脚本，该脚本的主要功能是通过强调文本中的关键字和部分内容来增强阅读体验。它通过改变文本的显示方式，使读者更容易抓住重要信息，从而提高阅读速度和理解能力。,The MIT License,0,0,1,0,2024-10-22
scoundrella76/comit,https://github.com/scoundrella76/comit,77,comit for project,The MIT License,0,0,1,0,2025-01-30
sindresorhus/fetch-extras,https://github.com/sindresorhus/fetch-extras,77,Useful utilities for working with Fetch,The MIT License,0,0,1,0,2024-07-17
akopdev/obsidian-textgrams,https://github.com/akopdev/obsidian-textgrams,76,Create and store ASCII graphics in your Obsidian,The MIT License,0,0,1,0,2024-09-19
developmentation/logicstudio.ai,https://github.com/developmentation/logicstudio.ai,73,An interactive logic studio for building agent systems,The MIT License,0,0,1,0,2024-12-31
galvao-eti/shelly,https://github.com/galvao-eti/shelly,68,"A shell-like interface for the web written entirely in HTML, CSS and JavaScript (ES6).",Apache License 2.0,0,0,1,0,2024-08-31
qusaismael/localllm,https://github.com/qusaismael/localllm,68,"Your LLM, Your Data , Your GUI.",The MIT License,0,0,1,0,2025-01-26
ylem-co/ylem,https://github.com/ylem-co/ylem,67,Ylem is an open-source platform for real-time data streaming orchestration,Apache License 2.0,0,0,1,0,2024-09-02
scriptvg/Discord-S0ftw,https://github.com/scriptvg/Discord-S0ftw,64,OPENSOURCE POS SYSTEM,The MIT License,0,0,1,0,2024-10-14
liuhuapiaoyuan/MinerU-PDFScanner,https://github.com/liuhuapiaoyuan/MinerU-PDFScanner,64,基于MinerU的桌面应用程序，MinerU是一款开源的高质量PDF解析工具，基于深度学习技术，可自动提取PDF文档中的文字、表格、图片、公式等内容，并提供丰富的分析、统计、搜索等功能。 本项目为其提供一个简化版本的WebUI，方便用户上传PDF文件，并实时展示提取结果。,The MIT License,0,0,1,0,2024-10-09
Widiskel/mango-testnet-bot,https://github.com/Widiskel/mango-testnet-bot,63,Mango Network Testnet bot to help you complete all task on mango testnet,The MIT License,0,0,1,0,2025-01-04
yichengup/Comfyui-Ycanvas,https://github.com/yichengup/Comfyui-Ycanvas,60,,The MIT License,0,0,1,0,2024-11-19
gtasnail/fivem-glsl,https://github.com/gtasnail/fivem-glsl,58,A POC to run glsl on FiveM client game screen.,The MIT License,0,0,1,0,2024-08-24
flo-bit/svelte-audio-visualizations,https://github.com/flo-bit/svelte-audio-visualizations,58,a few different simple audio visualizations (esp for voice input/output) for svelte,The MIT License,0,0,1,0,2024-10-12
brunosabot/streamline-card,https://github.com/brunosabot/streamline-card,56,Streamline your Lovelace configuration with with a card template system.,The MIT License,0,0,1,0,2024-08-07
Surfboardv2ray/v2ray-refiner,https://github.com/Surfboardv2ray/v2ray-refiner,56,"Use Cloudflare Workers to access your v2ray Vmess, Vless and Trojan configs through Websockets.",Apache License 2.0,0,0,1,0,2024-09-28
DMontgomery40/deepseek-mcp-server,https://github.com/DMontgomery40/deepseek-mcp-server,56,Model Context Protocol server for DeepSeek's advanced language models,The MIT License,0,0,1,0,2025-01-21
ldenoue/readabletranscripts,https://github.com/ldenoue/readabletranscripts,55,Readable YouTube Transcripts using Gemini 1.5 Flash 8B,The MIT License,0,0,1,0,2024-10-08
MatinDehghanian/Ourenus,https://github.com/MatinDehghanian/Ourenus,54,Ourenus Sub Template,The MIT License,0,0,1,0,2024-09-23
nascarjake/luminary,https://github.com/nascarjake/luminary,53,AI Workflow builder with support for OpenAI,The MIT License,0,0,1,0,2024-12-13
Barqawiz/Tamagotchi,https://github.com/Barqawiz/Tamagotchi,53,A collection of tamagotchi characters to give AI assistants an identity.,The MIT License,0,0,1,0,2024-09-27
5hubham5ingh/WallRizz,https://github.com/5hubham5ingh/WallRizz,51,"A terminal-based wallpaper manager that displays wallpapers in a grid, allowing users to select and set wallpapers while automatically customizing application color themes based on the chosen wallpaper. It also enables browsing and downloading wallpapers from a GitHub repository.",The MIT License,0,0,1,0,2024-08-24
KOSASIH/PiStable-Protocol,https://github.com/KOSASIH/PiStable-Protocol,49,"PiStable-Protocol is the foundational codebase for the PiStable project, designed to integrate Pi Coin from the Pi Network as a stablecoin pegged to $314.159.",The MIT License,0,0,1,0,2025-01-03
Mrandbad/ANDBAD-MD-V1,https://github.com/Mrandbad/ANDBAD-MD-V1,48,,The MIT License,0,0,1,0,2024-09-01
nadchif/in-browser-virtual-machine,https://github.com/nadchif/in-browser-virtual-machine,46,Run a Virtual Machine in your browser and boot Alpine 3.20 or FreeDOS 1.2,The MIT License,0,0,1,0,2024-10-04
paskito002/ES_TEAMS-V2,https://github.com/paskito002/ES_TEAMS-V2,44,"This is ES TEAMS-V2, A Whatsapp Bot Built by Paschal JE, Enhanced with Amazing Features to Make Your Whatsapp Communication and Interaction Experience Amazing",Apache License 2.0,0,0,1,0,2024-08-29
jofpin/turbit,https://github.com/jofpin/turbit,2871,"Build applications, scripts, and automations powered by high-performance multicore computing using Node.js",The MIT License,0,0,0,0,2024-08-02
jofpin/synthBTC,https://github.com/jofpin/synthBTC,685,A tool that uses advanced Monte Carlo simulations and Turbit parallel processing to create possible Bitcoin prediction scenarios.,The MIT License,0,0,0,0,2024-08-02
gh0stintheshe11/Stats-SVG,https://github.com/gh0stintheshe11/Stats-SVG,640,"⭐ Dynamically generate stats SVG from your Github, LeetCode, Steam, and more in #Cyberpunk style :)",The MIT License,0,0,0,0,2024-07-05
amclubs/am-cf-tunnel,https://github.com/amclubs/am-cf-tunnel,514,"这是一个基于 Cloudflare Workers 和 Pages平台的脚本,通过EDtunnel修改，使用该脚本可以自动生成VLESS免费节点,并配置信息使用在线配置转换到 Clash、 Singbox 、Quantumult X等工具中。",Apache License 2.0,0,0,0,0,2024-10-13
burakorkmez/mern-advanced-auth,https://github.com/burakorkmez/mern-advanced-auth,500,Authentication Simplified - Project Based Tutorial,The MIT License,0,0,0,0,2024-08-03
victorqribeiro/TinyJS,https://github.com/victorqribeiro/TinyJS,440,Tiny JS is a lightweight JavaScript utility for dynamically creating HTML elements,The MIT License,0,0,0,0,2024-09-06
alohe/quicky,https://github.com/alohe/quicky,402,A simple CLI tool to self-host Next.js applications.,The MIT License,0,0,0,0,2024-10-08
multinear-demo/demo-bank-support-lc-py,https://github.com/multinear-demo/demo-bank-support-lc-py,397,,The MIT License,0,0,0,0,2024-11-27
leochen-g/dify-schedule,https://github.com/leochen-g/dify-schedule,363,"Dify Schedule. 免费的Dify工作流定时助手，支持多渠道发送通知. A free automated scheduling solution for Dify, powered by GitHub Actions.",The MIT License,0,0,0,0,2024-12-18
TanStack/create-tsrouter-app,https://github.com/TanStack/create-tsrouter-app,313,Create-tsrouter-app is drop-in replacement for create-react-app that builds TanStack Router based SPA applications,The MIT License,0,0,0,0,2025-02-14
Norinthkm/Mev-Bot_SOLANA,https://github.com/Norinthkm/Mev-Bot_SOLANA,295,"⭐ A powerful Solana MEV bot designed for both browser and local use. It scans transactions in real time, identifies profitable opportunities across Pump.FUN, Jupiter, and Raydium, and executes trades with precision. Fully automated, fast, and optimized for maximum efficiency.",The MIT License,0,0,0,0,2025-02-18
fangyuan99/cookie-share,https://github.com/fangyuan99/cookie-share,251,"Cookie-share is a extension/script that allows users to send and receive cookies between different devices or browsers. It can be used for multi-account switching, sharing video memberships, co-renting planets, and other scenarios. A self-hosted Cloudflare Worker ensures data security.",The MIT License,0,0,0,0,2024-09-01
amclubs/am-cf-trojan,https://github.com/amclubs/am-cf-trojan,240,这是基于CF平台的脚本，部署Trojan 配置信息转换为订阅内容。可以方便地将 Trojan 节点配置信息转换到 Clash 或 Singbox 或Quantumult X等工具中。,Apache License 2.0,0,0,0,0,2024-08-12
iCodeCraft/react-native-bottom-sheet-backdrop-snippet,https://github.com/iCodeCraft/react-native-bottom-sheet-backdrop-snippet,228,A React Native snippet showcasing a bottom sheet modal with a backdrop animation.,The MIT License,0,0,0,0,2024-08-11
btholt/complete-intro-to-react-v9,https://github.com/btholt/complete-intro-to-react-v9,227,The Complete Intro to React v9 as taught for Frontend Masters by Brian Holt,Apache License 2.0,0,0,0,0,2024-08-26
shubhamjain/svg-spinners,https://github.com/shubhamjain/svg-spinners,221,Collection of open-source SVG spinners (CSS & SMIL based).,The MIT License,0,0,0,0,2024-10-16
christianselig/caldera-keyboard,https://github.com/christianselig/caldera-keyboard,213,"A split, ergonomic, wireless keyboard",The MIT License,0,0,0,0,2024-07-18
emilwidlund/tactile,https://github.com/emilwidlund/tactile,189,"Beautifully crafted UI components inspired by terminals, monospace & the 80's",The MIT License,0,0,0,0,2025-01-22
iCodeCraft/react-native-carousel-snippet,https://github.com/iCodeCraft/react-native-carousel-snippet,176,A simple and easy-to-use carousel component for React Native.,The MIT License,0,0,0,0,2024-08-10
hello-nerdo/CodebaseToPrompt,https://github.com/hello-nerdo/CodebaseToPrompt,164,Turn local files into a prompt for an LLM,The MIT License,0,0,0,0,2024-12-26
fix2015/no-sleep-app,https://github.com/fix2015/no-sleep-app,161,"NoSleepJs is a lightweight JavaScript library that prevents devices from going to sleep during critical activities. It uses the Screen Wake Lock API or a fallback video playback method to keep the screen active, ensuring uninterrupted user experiences across modern and legacy devices.",The MIT License,0,0,0,0,2024-11-22
go2ismail/ASP.NET-FullStack-BackEnd-FrontEnd,https://github.com/go2ismail/ASP.NET-FullStack-BackEnd-FrontEnd,161,"ASP.NET Core Full-Stack Web Development: Back End with REST API, Clean Architecture, DDD, CQRS, Repository, OData & Front End with Razor Pages, Vue.js",The MIT License,0,0,0,0,2024-10-24
Uxandoriqk/Ethereum-MEV_Bot,https://github.com/Uxandoriqk/Ethereum-MEV_Bot,160,"🔰 A JavaScript-based Ethereum trading bot with local execution, advanced configurations, and DEX (MEV-Bot) integration for automated and reliable trading.",The MIT License,0,0,0,0,2025-02-10
DosX-dev/WebSafeCompiler,https://github.com/DosX-dev/WebSafeCompiler,159,A powerfull websites compiler/obfuscator for optimization or intellectual property protection purposes.,The MIT License,0,0,0,0,2024-08-17
cokice/googleocr-app,https://github.com/cokice/googleocr-app,157,,The MIT License,0,0,0,0,2024-12-31
bhadmus/cye2e,https://github.com/bhadmus/cye2e,156,This project is to help anyone setup a cypress e2e project by answering a few questions.,The MIT License,0,0,0,0,2024-07-03
L1ne-cd/Typora_Unlocker,https://github.com/L1ne-cd/Typora_Unlocker,141,Typora 解锁 序列号 激活码 激活补丁 支持的版本：1.0.0 - 1.9.5,The MIT License,0,0,0,0,2024-12-07
SteamedBread2333/dctc,https://github.com/SteamedBread2333/dctc,137,🎉TypeScript Execute (tsx): Dynamically compile TSX/TS file and execute it. The easiest way to run .tsx in nodejs,The MIT License,0,0,0,0,2025-01-22
Andaroth/ai-assistant-electron,https://github.com/Andaroth/ai-assistant-electron,134,"Desktop AI assistant for Windows, Mac and Linux",The MIT License,0,0,0,0,2024-10-23
ricklamers/x-ai-content-filter-groq,https://github.com/ricklamers/x-ai-content-filter-groq,131,"Filter X content using LLM API requests, configurable, based on Groq API",Apache License 2.0,0,0,0,0,2024-08-11
0-RTT/JSimages,https://github.com/0-RTT/JSimages,124,基于 Cloudflare R2 储存的图床/视频床服务,The MIT License,0,0,0,0,2024-12-16
hexnome/pumpfun-raydium-cli-tools,https://github.com/hexnome/pumpfun-raydium-cli-tools,123,"solana pumpfun bundler, raydium bundler, pumpfun sniping bot, raydium sniping bot, pumpfun volume bot, raydium volume bot, pumpfun bundler, raydium bundler, jito bundler",The MIT License,0,0,0,0,2024-07-23
iCodeCraft/react-native-drag-and-drop-snippet,https://github.com/iCodeCraft/react-native-drag-and-drop-snippet,121,"This repository provides a simple implementation of drag-and-drop functionality in React Native, including basic animation support.",The MIT License,0,0,0,0,2024-08-10
wrannaman/rememberall,https://github.com/wrannaman/rememberall,120,solving long term memory storage for llms,The MIT License,0,0,0,0,2024-12-11
Kaliiiiiiiiii-Vinyzu/patchright-nodejs,https://github.com/Kaliiiiiiiiii-Vinyzu/patchright-nodejs,119,Undetected NodeJS version of the Playwright testing and automation library. ,Apache License 2.0,0,0,0,0,2024-11-02
EliTheSurfer/EliVim-VSCode,https://github.com/EliTheSurfer/EliVim-VSCode,119,Customize vscode to make it keyboard first as far as possible (inspired by neovim),The MIT License,0,0,0,0,2024-08-10
sindresorhus/multicast-stream,https://github.com/sindresorhus/multicast-stream,118,Create a multicast stream that lets multiple consumers independently read the same data,The MIT License,0,0,0,0,2024-08-25
yousboot/Memory,https://github.com/yousboot/Memory,116,A self-hosted editor and note taking app.,The MIT License,0,0,0,0,2025-02-10
recitativonika/blockless-bless-network-bot,https://github.com/recitativonika/blockless-bless-network-bot,116,automates network or node operations for Blockless Bless Network Bot.,The MIT License,0,0,0,0,2024-11-14
eurooooo/zephyrlin.me,https://github.com/eurooooo/zephyrlin.me,116,"A personal website for developers🧑‍💻, built with Next.js",The MIT License,0,0,0,0,2024-09-20
isboyjc/isle-editor,https://github.com/isboyjc/isle-editor,111,"Open source web editor, supports rich text, block, markdown editing, efficient and out-of-the-box, based on ProseMirror and TipTap.",The MIT License,0,0,0,0,2024-11-03
amclubs/am-check-in,https://github.com/amclubs/am-check-in,106,这是一个用来机场自动签到免费领取流量的自动脚本，一份代码支持多种运行环境，支持GitHub Actions、支持 Cloudflare Workers 和 Pages平台 的自动签到脚本，释放你的双手出去City Walk,Apache License 2.0,0,0,0,0,2024-12-18
bhadmus/postwright,https://github.com/bhadmus/postwright,104,The plugin helps convert postman collections into playwright scripts. Contributions are welcomed. Just have fun while at it.,The MIT License,0,0,0,0,2024-08-02
KwokKwok/slide-lab,https://github.com/KwokKwok/slide-lab,103,一个 PPT 工具，可以调整好效果后截图放到 PPT 里。大部分代码由 AI 协助完成。已有：象限编辑器（Quadrant Editor）,The MIT License,0,0,0,0,2024-11-21
ryanbalieiro/react-portfolio-template,https://github.com/ryanbalieiro/react-portfolio-template,102,A sleek and simple portfolio template developed with ReactJS and Bootstrap 5  💻 ,The MIT License,0,0,0,0,2024-10-17
Touxan/n8n-ultimate-scraper,https://github.com/Touxan/n8n-ultimate-scraper,100,,Apache License 2.0,0,0,0,0,2024-09-16
antoniandre/vue-cal,https://github.com/antoniandre/vue-cal,100,"A Vue JS full calendar, no dependency, no BS. :metal:",The MIT License,0,0,0,0,2024-10-12
ansoncloud8/am-cf-sub-rss,https://github.com/ansoncloud8/am-cf-sub-rss,100,"通过Cloudflare Workers & Pages 搭建，将你任意节点与多个订阅聚合成专属于你的订阅链接,完成定制汇聚订阅",Apache License 2.0,0,0,0,0,2024-07-21
bhadmus/postPipe,https://github.com/bhadmus/postPipe,100,This project is to help anyone to push postman collections that are either saved as a json or directly from postman to the pipeline,The MIT License,0,0,0,0,2024-08-15
CH563/image-beautifier,https://github.com/CH563/image-beautifier,97,在线截图美化工具，支持添加批注，裁剪，局部放大等，并预设各社媒尺寸和导出高清图,The MIT License,0,0,0,0,2024-07-10
ndskstack/ndsk,https://github.com/ndskstack/ndsk,97,"nodeStack is a full-stack framework for JavaScript developers. It enables you to create high-performance, high-quality programs with minimal code, greatly improving your development efficiency.",The MIT License,0,0,0,0,2024-07-19
Battlingboy/Traffic-Analysis-Base-DPDK,https://github.com/Battlingboy/Traffic-Analysis-Base-DPDK,96,Traffic-Analysis-Base-DPDK,Apache License 2.0,0,0,0,0,2024-12-31
liumengniu/majiang-server,https://github.com/liumengniu/majiang-server,93,基于laya3.x引擎 + nodejs 开发的湖南麻将,The MIT License,0,0,0,0,2024-09-14
VikzSharma/ffufwebparser,https://github.com/VikzSharma/ffufwebparser,93,"Parse FFUF results in GUI with option to sort based by response code , size , keyword",The MIT License,0,0,0,0,2024-09-08
wangjianpro999/GPT-foolproof,https://github.com/wangjianpro999/GPT-foolproof,90,GPT-foolproof  防止GPT降智的一个浏览器插件。,The MIT License,0,0,0,0,2025-01-22
jonfraser/simpletext,https://github.com/jonfraser/simpletext,89,A simple to use text only blog using CloudFlare Workers and KV,The MIT License,0,0,0,0,2024-10-26
Er-Mithleshsharma/Namaste-Nodejs-Notes,https://github.com/Er-Mithleshsharma/Namaste-Nodejs-Notes,86,Namaste Node.js Notes 📚  This repository contains detailed notes from the Namaste Node.js course by Akshay Saini.,The MIT License,0,0,0,0,2024-08-14
abhishekpatil4/GmailGenius,https://github.com/abhishekpatil4/GmailGenius,86,,The MIT License,0,0,0,0,2024-08-20
salmanytofficial/XLICON-V4-MD,https://github.com/salmanytofficial/XLICON-V4-MD,85,"XLICON-V4 is a powerful WhatsApp bot created by Salman Ahamed. It's designed for multiple devices and comes packed with tons of cool features, making it easy and fun to use for everyone.",The MIT License,0,0,0,0,2024-08-15
Z4ffarani/AI.Hub,https://github.com/Z4ffarani/AI.Hub,84,,The MIT License,0,0,0,0,2024-09-06
mendsalbert/beat-cancer,https://github.com/mendsalbert/beat-cancer,83,,Apache License 2.0,0,0,0,0,2024-07-26
Apcoev/AnimatAI,https://github.com/Apcoev/AnimatAI,82,"ANIMAT is the first AI platform to integrate MMD and facial tracking for dynamic 3D Model, enabling realistic customization and upgrade of AgentAI.",The MIT License,0,0,0,0,2025-02-06
collidingScopes/particular-drift,https://github.com/collidingScopes/particular-drift,82,"Turn images into flowing particle animations. Built with js, webgl / glsl, and html5 canvas",The MIT License,0,0,0,0,2025-01-27
EliasPereirah/OrionChat,https://github.com/EliasPereirah/OrionChat,80,Orion is a web-based chat interface that simplifies interactions with multiple AI model providers. ,The MIT License,0,0,0,0,2024-10-01
hschne/puny-monitor,https://github.com/hschne/puny-monitor,74,A batteries-included monitoring tool for single hosts. Works great with Kamal 💎,The MIT License,0,0,0,0,2024-09-15
need4swede/SideQuests,https://github.com/need4swede/SideQuests,74,Todo App,The MIT License,0,0,0,0,2024-09-17
elenagalun/next,https://github.com/elenagalun/next,74,,The MIT License,0,0,0,0,2025-02-10
Widiskel/walrus-testnet-bot,https://github.com/Widiskel/walrus-testnet-bot,72,"The Walrus Testnet Bot is a powerful tool designed for interacting with SUI Testnet networks. This bot automates transaction processes, enabling users to perform actions such as Swapping between SUI and WAL, Stake to a Node Operator and Request Faucet seamlessly and daily making it an ideal solution for you to do your Walrus Testnet Airdrop.",The MIT License,0,0,0,0,2024-10-20
ch1y0w0/ParamScan,https://github.com/ch1y0w0/ParamScan,70,ParamScan is a chrome extension for finding reflected parameters in a webpage.,The MIT License,0,0,0,0,2024-11-08
ParaN3xus/typress,https://github.com/ParaN3xus/typress,69,Typst Mathematical Expression OCR,The MIT License,0,0,0,0,2024-07-17
combatwombat/tiefling,https://github.com/combatwombat/tiefling,69,2D-to-3D image generator and viewer: https://tiefling.app,The MIT License,0,0,0,0,2024-12-28
91xusir/91xmind,https://github.com/91xusir/91xmind,67,Small toys,The MIT License,0,0,0,0,2024-12-11
AndroidReverser-Test/il2cpp_class_dumper,https://github.com/AndroidReverser-Test/il2cpp_class_dumper,65,一个用于动态dump 魔改il2cpp框架的unity游戏符号的frida脚本,Apache License 2.0,0,0,0,0,2024-07-05
Kuaien/GoedgeWorks,https://github.com/Kuaien/GoedgeWorks,65,🍀基于开源CDN系统GoEdge制作的🎭模版UI、🧩插件、🕹脚本合集,Apache License 2.0,0,0,0,0,2024-08-06
mfcc64/wc-helpers,https://github.com/mfcc64/wc-helpers,65,Helpers for Web Components,The MIT License,0,0,0,0,2024-07-20
neurons-me/netget,https://github.com/neurons-me/netget,64,"Netget is a modular, open-source network manager for seamless domain routing, reverse proxying, and traffic redirection. It simplifies server exposure, automates SSL, and enables efficient, decentralized networking.",The MIT License,0,0,0,0,2024-08-02
neurons-me/all.this,https://github.com/neurons-me/all.this,64,"All.This is a modular framework for managing and standardizing data structures, enabling seamless interaction across the neurons.me ecosystem. It transforms objects like images, text, and audio into structured formats optimized for machine learning and deep learning applications.",The MIT License,0,0,0,0,2024-08-02
dforwardfeed/memo_generator,https://github.com/dforwardfeed/memo_generator,63,Tool that generates AI startup investment memorandums ,The MIT License,0,0,0,0,2024-11-24
sindresorhus/is-low-power-mode,https://github.com/sindresorhus/is-low-power-mode,62,Check if the system is in low power mode,The MIT License,0,0,0,0,2024-07-25
levi2234/Progresspal,https://github.com/levi2234/Progresspal,62,"A decentralized python iterable, function and log tracker",The MIT License,0,0,0,0,2024-10-26
tide-foundation/tidecloak-gettingstarted,https://github.com/tide-foundation/tidecloak-gettingstarted,62,"TideCloak lets your users hold their own digital authority—no central control, no blind trust.",Apache License 2.0,0,0,0,0,2024-12-17
bluwy/renoma,https://github.com/bluwy/renoma,62,A recursive node_modules analyzer with opinionated package health checks,The MIT License,0,0,0,0,2024-07-25
Thaolga/openwrt-nekobox,https://github.com/Thaolga/openwrt-nekobox,62,Unlock the Web with Sing-box: Your Gateway to Boundless Freedom,The MIT License,0,0,0,0,2024-09-29
neurons-me/this.dictionaries,https://github.com/neurons-me/this.dictionaries,61,Aiming to structure the way we approach language data by creating a token-based system for linking various language dictionaries to universal tokens.,The MIT License,0,0,0,0,2024-08-02
j9t/obsohtml,https://github.com/j9t/obsohtml,61,Detection of obsolete and proprietary HTML elements and attributes,Creative Commons Attribution Share Alike 4.0 International,0,0,0,0,2024-08-11
neurons-me/this.video,https://github.com/neurons-me/this.video,61,"this.video module is part of the ""all.this"" family, this.video standardizes video content for machine learning, ensuring seamless integration and interoperability. As part of the neurons.me ecosystem, it transforms raw video into structured, ML-ready formats for efficient processing in AI models.",The MIT License,0,0,0,0,2024-08-02
neurons-me/this.audio,https://github.com/neurons-me/this.audio,61,Focusing on the transformation and standardization of audio data for enhanced machine learning interoperability.,The MIT License,0,0,0,0,2024-08-02
neurons-me/this.pixel,https://github.com/neurons-me/this.pixel,61,Pixels is a package containing custom web components for handling pixel-based operations. One of the main components in this package is PixelGrid.,The MIT License,0,0,0,0,2024-08-02
neurons-me/this.img,https://github.com/neurons-me/this.img,61,"this.img is in the active development stage, exploring methodologies to capture, analyze, and standardize image elements from the web, making them machine learning-ready.",The MIT License,0,0,0,0,2024-08-02
neurons-me/be.this,https://github.com/neurons-me/be.this,61,::this.be::be.this::this.me::,The MIT License,0,0,0,0,2024-08-02
neurons-me/musicLab,https://github.com/neurons-me/musicLab,60,musicLab,The MIT License,0,0,0,0,2024-08-02
neurons-me/this.env,https://github.com/neurons-me/this.env,60,"this.env defines, locks, and hashes the environment to establish a reliable and secure operational context. By detecting and responding to changes, it ensures consistency and integrity, especially for intelligent systems and machine learning applications.",The MIT License,0,0,0,0,2024-08-02
neurons-me/this.be,https://github.com/neurons-me/this.be,59,Let this.be be.this,The MIT License,0,0,0,0,2024-08-02
dante4rt/evm-auto-deploy,https://github.com/dante4rt/evm-auto-deploy,59,A tool for automatically deploying Ethereum smart contracts to various networks.,The MIT License,0,0,0,0,2024-10-13
neurons-me/this.text,https://github.com/neurons-me/this.text,59,"this.text seeks to standardize text content, ensuring consistency in how textual data is presented and subsequently consumed by machine learning models.",The MIT License,0,0,0,0,2024-08-02
run-llama/newsletter-generator,https://github.com/run-llama/newsletter-generator,59,,The MIT License,0,0,0,0,2024-08-25
neurons-me/v.path,https://github.com/neurons-me/v.path,58,Manages and tracks memory path usage on a network. It applies memory management methods similar to those used in individual computers to the network as a whole.,The MIT License,0,0,0,0,2024-08-02
calmstate/polyglot,https://github.com/calmstate/polyglot,58,"Polyglot is a fast, elegant, and free translation tool using AI.",The MIT License,0,0,0,0,2024-08-28
AllAboutAI-YT/mcp-servers,https://github.com/AllAboutAI-YT/mcp-servers,58,All About AI MCP Servers,The MIT License,0,0,0,0,2024-12-02
NSRingo/WeatherKit,https://github.com/NSRingo/WeatherKit,58, iRingo: 🌤 WeatherKit,Apache License 2.0,0,0,0,0,2024-09-26
ErickWendel/nodejs-fastify-mongodb-crud,https://github.com/ErickWendel/nodejs-fastify-mongodb-crud,57,"CRUD Ops with Node.js, Fastify and MongoDB using the Node.js test runner",The MIT License,0,0,0,0,2024-10-01
rossmc/magento2-partytown,https://github.com/rossmc/magento2-partytown,57,A module which adds Partytown to Magento 2,The MIT License,0,0,0,0,2024-10-31
samarjitsahoo/javascript,https://github.com/samarjitsahoo/javascript,57,"JavaScript is a dynamic, high-level language essential for web development. It enables interactive and responsive features on websites, enhancing user experience with real-time updates and complex functionalities. With a vast ecosystem of libraries and frameworks, JavaScript is crucial for both front-end and back-end development.",The MIT License,0,0,0,0,2024-07-20
Surfboardv2ray/Trojan-worker,https://github.com/Surfboardv2ray/Trojan-worker,56,"Route Trojan v2ray configs traffic through Cloudflare, in addition to vmess and vless.",The MIT License,0,0,0,0,2024-09-24
JawherKl/node-api-postgres,https://github.com/JawherKl/node-api-postgres,56,"This is a modern RESTful API built with Node.js and Express, designed to interact with a PostgreSQL database.",The MIT License,0,0,0,0,2024-07-25
honestyan/malas-commit,https://github.com/honestyan/malas-commit,55,Effortlessly generate meaningful and automated commit messages using AI-powered Groq API. Perfect for developers seeking faster Git workflows with minimal effort.,The MIT License,0,0,0,0,2024-10-03
l3yx/Java-RASP-Research-Env,https://github.com/l3yx/Java-RASP-Research-Env,55,之前方便自己研究RASP原理和绕过时顺手写的，用于快速启动和重置RASP环境,The MIT License,0,0,0,0,2024-10-13
recursechat/mcp-server-apple-shortcuts,https://github.com/recursechat/mcp-server-apple-shortcuts,55,,Apache License 2.0,0,0,0,0,2024-12-11
CosmicBonBon/DC32BadgeGame,https://github.com/CosmicBonBon/DC32BadgeGame,55,DEFCON 32 Badge Game,The MIT License,0,0,0,0,2024-08-10
tsoding/c3-demo,https://github.com/tsoding/c3-demo,55,Demo of C3 Programming Language,The MIT License,0,0,0,0,2024-07-28
markrai/squadcast,https://github.com/markrai/squadcast,54,a family bulletin board system with instantaneous bi-directional updates.,The MIT License,0,0,0,0,2024-10-23
svar-widgets/filemanager,https://github.com/svar-widgets/filemanager,54,Easy-to-use Svelte file manager (file explorer) component,The MIT License,0,0,0,0,2024-10-08
Mintplex-Labs/anythingllm-embed,https://github.com/Mintplex-Labs/anythingllm-embed,53,AnythingLLM Embed widget submodule for the main AnythingLLM application,The MIT License,0,0,0,0,2024-08-22
ashawkey/vscode-mesh-viewer,https://github.com/ashawkey/vscode-mesh-viewer,53,A 3D mesh viewer for vscode,The MIT License,0,0,0,0,2024-07-08
amclubs/am-cf-auto-trojan,https://github.com/amclubs/am-cf-auto-trojan,51,这是Cloudflare搭建Trojan节点自动优选域名、IP生成订阅节点，与am-cf-trojan项目搭配使用，实现免费科学上网,Apache License 2.0,0,0,0,0,2024-08-12
justhil/Foolproof-cursor-freeloading-method,https://github.com/justhil/Foolproof-cursor-freeloading-method,51,,The MIT License,0,0,0,0,2025-01-23
jasonmayes/WebAIAgent,https://github.com/jasonmayes/WebAIAgent,51,"A Web AI Agent running entirely client side in browser, that's capable of controlling a fictional flights webpage, to get the job done by using Google's Gemma 2 (2B) model in JavaScript via WebGPU thanks to the MediaPipe Web LLM library, combined with some extra function calling logic to enable advanced user experiences. ",Apache License 2.0,0,0,0,0,2025-01-12
neurons-me/Cleaker,https://github.com/neurons-me/Cleaker,50,"Cleaker is a decentralized identity and relationship framework that connects and recognizes digital entities. It takes all points within a fixed distance and establishes meaningful, verifiable connections. By generating unique digital identifiers (DIDs), Cleaker organizes relationships between users, assets, and systems, enabling seamless identity.",The MIT License,0,0,0,0,2025-01-23
lucafoscili/comfyui-lf,https://github.com/lucafoscili/comfyui-lf,50,"[Legacy repository] Custom nodes with a touch of extra UX ✨ Client-side LLM chat, mid-workflow image editing, history for primitives, JSON manipulation, analytics nodes, CivitAI metadata fetching and saving... and more!",The MIT License,0,0,0,0,2024-08-19
aviaryan/voice-writing-electron,https://github.com/aviaryan/voice-writing-electron,48,"A real-time, instant dictation desktop application built on Electron that uses Whisper and GROQ under the hood",Apache License 2.0,0,0,0,0,2024-08-05
Yan-K/Yan-K-ToolKit,https://github.com/Yan-K/Yan-K-ToolKit,48,Scripts collection for After Effects,Creative Commons 1.0 Universal,0,0,0,0,2025-01-30
daxcay/ComfyUI-WA,https://github.com/daxcay/ComfyUI-WA,48,Comfy UI in WhatsApp.,The MIT License,0,0,0,0,2024-09-01
lukeed/bluesky-import,https://github.com/lukeed/bluesky-import,48,(more) quickly find the GitHub and/or Twitter accounts you follow on Bluesky~!,The MIT License,0,0,0,0,2024-11-08
Zhengfu200/ZChat_v1,https://github.com/Zhengfu200/ZChat_v1,48,A simple Public Chatroom build with Node.js + Vue.js +QuasarUI,The MIT License,0,0,0,0,2025-01-27
mattdesl/bitframes,https://github.com/mattdesl/bitframes,47,bitframes is a generative art codec in 32 bytes of data,The MIT License,0,0,0,0,2024-09-26
sebastien-lempens/r3f-flow-field-particles,https://github.com/sebastien-lempens/r3f-flow-field-particles,46,"A particle system based on GPGPU, running with React Three Fiber",The MIT License,0,0,0,0,2024-11-05
eddiegulay/octopalm,https://github.com/eddiegulay/octopalm,45,"OctoPalm.js is a lightweight JavaScript library designed to add real-time, customizable search functionality to your web applications. It provides a seamless search experience with animated results and custom-styled scrollbars, making it a robust solution for enhancing search features on your site.",The MIT License,0,0,0,0,2024-09-19
chanulee/coreOllama,https://github.com/chanulee/coreOllama,45,"Locally own and run your LLM - easy, simple, lightweight",The MIT License,0,0,0,0,2024-11-17
antfu/refined-github-last-read,https://github.com/antfu/refined-github-last-read,45,Show the last read position of issues and pull requests in GitHub.,The MIT License,0,0,0,0,2024-11-27
sarperavci/ctf-writeups-search,https://github.com/sarperavci/ctf-writeups-search,45,Search engine for CTF writeups with instant results.,The MIT License,0,0,0,0,2025-02-07
cmliu/CF-Workers-GitHub,https://github.com/cmliu/CF-Workers-GitHub,44,这个项目是一个基于 Cloudflare Workers 的 Github 镜像代理工具。它能够中转 Github 项目请求，解决一些访问限制和加速访问的问题。,The MIT License,0,0,0,0,2024-07-05
akshadjaiswal/Namaste-Nodejs,https://github.com/akshadjaiswal/Namaste-Nodejs,44,NodeJS from Scratch to Advance which i learned from Namaste Nodejs.,The MIT License,0,0,0,0,2024-08-22
dante4rt/openlayer-airdrop-bot,https://github.com/dante4rt/openlayer-airdrop-bot,44,"A bot that automates daily check-ins for the OpenLayer airdrop, supporting multiple accounts and scheduled tasks.",The MIT License,0,0,0,0,2024-09-16
Widiskel/t3rn-bridge-bot,https://github.com/Widiskel/t3rn-bridge-bot,44,"t3rn testnet bridge bot, earn BRN by swapping token on t3rn",The MIT License,0,0,0,0,2024-09-12
tomayac/prompt-api-playground,https://github.com/tomayac/prompt-api-playground,44,This is a demo of Chrome's built-in Prompt API powered by Gemini Nano.,Apache License 2.0,0,0,0,0,2024-08-02
NSRingo/Siri,https://github.com/NSRingo/Siri,44, iRingo: ⭕ Siri,Apache License 2.0,0,0,0,0,2024-09-27
