name,url,stars,description,license,question_issues,help_wanted_issues,total_issues,community_score,created_at
SWivid/F5-TTS,https://github.com/SWivid/F5-TTS,9725,"Official code for ""F5-TTS: A Fairytaler that Fakes Fluent and Faithful Speech with Flow Matching""",The MIT License,117,84,37,201,2024-10-08
DS4SD/docling,https://github.com/DS4SD/docling,21476,Get your documents ready for gen AI,The MIT License,100,11,168,111,2024-07-09
kyutai-labs/moshi,https://github.com/kyutai-labs/moshi,7512,"Moshi is a speech-text foundation model and full-duplex spoken dialogue framework. It uses Mimi, a state-of-the-art streaming neural audio codec.",Apache License 2.0,83,0,36,83,2024-08-07
NVIDIA/Cosmos,https://github.com/NVIDIA/Cosmos,7512,"Cosmos is a world model development platform that consists of world foundation models, tokenizers and video processing pipeline to accelerate the development of Physical AI at Robotics & AV labs.  Cosmos is purpose built for physical AI. The Cosmos repository will enable end users to run the Cosmos models, run inference scripts and generate videos.",Apache License 2.0,52,0,22,52,2024-12-30
microsoft/VPTQ,https://github.com/microsoft/VPTQ,588,"VPTQ, A Flexible and Extreme low-bit quantization algorithm",The MIT License,27,0,17,27,2024-08-13
balazik/ComfyUI-PuLID-Flux,https://github.com/balazik/ComfyUI-PuLID-Flux,551,PuLID-Flux ComfyUI implementation,Apache License 2.0,1,24,66,25,2024-10-01
av/harbor,https://github.com/av/harbor,1274,"Effortlessly run LLM backends, APIs, frontends, and services with one command.",Apache License 2.0,21,3,35,24,2024-07-27
chaidiscovery/chai-lab,https://github.com/chaidiscovery/chai-lab,1535,"Chai-1, SOTA model for biomolecular structure prediction",Apache License 2.0,22,1,59,23,2024-09-09
jingyaogong/minimind,https://github.com/jingyaogong/minimind,10594,üöÄüöÄ „ÄåÂ§ßÊ®°Âûã„Äç2Â∞èÊó∂ÂÆåÂÖ®‰ªé0ËÆ≠ÁªÉ26MÁöÑÂ∞èÂèÇÊï∞GPTÔºÅüåè Train a 26M-parameter GPT from scratch in just 2h!,Apache License 2.0,22,0,25,22,2024-07-27
PKU-Alignment/align-anything,https://github.com/PKU-Alignment/align-anything,2090,Align Anything: Training All-modality Model with Feedback,Apache License 2.0,18,0,15,18,2024-07-14
volcengine/verl,https://github.com/volcengine/verl,3438,verl: Volcano Engine Reinforcement Learning for LLMs,Apache License 2.0,12,2,86,14,2024-10-31
HKUDS/LightRAG,https://github.com/HKUDS/LightRAG,11982,"""LightRAG: Simple and Fast Retrieval-Augmented Generation""",The MIT License,14,0,48,14,2024-10-02
codelion/optillm,https://github.com/codelion/optillm,2043,Optimizing inference proxy for LLMs,Apache License 2.0,13,1,8,14,2024-08-22
modelcontextprotocol/python-sdk,https://github.com/modelcontextprotocol/python-sdk,1930,The official Python SDK for Model Context Protocol servers and clients,The MIT License,5,7,56,12,2024-09-24
vllm-project/production-stack,https://github.com/vllm-project/production-stack,479,Scale from single vLLM instance to distributed vLLM deployment without changing any application code.,Apache License 2.0,4,8,25,12,2025-01-21
jlowin/fastmcp,https://github.com/jlowin/fastmcp,1015,"The fast, Pythonic way to build Model Context Protocol servers üöÄ ",The MIT License,7,5,21,12,2024-11-30
ai-christianson/RA.Aid,https://github.com/ai-christianson/RA.Aid,447,Develop software autonomously.,Apache License 2.0,0,11,20,11,2024-12-10
bytedance/Protenix,https://github.com/bytedance/Protenix,937,A trainable PyTorch reproduction of AlphaFold 3.,Apache License 2.0,10,0,14,10,2024-11-08
openreasoner/openr,https://github.com/openreasoner/openr,1646,OpenR: An Open Source Framework for Advanced Reasoning with Large Language Models,The MIT License,7,1,43,8,2024-10-11
zjunlp/OmniThink,https://github.com/zjunlp/OmniThink,389,OmniThink: Expanding Knowledge Boundaries in Machine Writing through Thinking,The MIT License,8,0,7,8,2024-12-10
circlemind-ai/fast-graphrag,https://github.com/circlemind-ai/fast-graphrag,2927,"RAG that intelligently adapts to your use case, data, and queries",The MIT License,0,6,27,6,2024-10-30
calibrain/calibre-web-automated-book-downloader,https://github.com/calibrain/calibre-web-automated-book-downloader,499,,The MIT License,0,6,24,6,2024-12-16
huanngzh/ComfyUI-MVAdapter,https://github.com/huanngzh/ComfyUI-MVAdapter,278,Custom nodes for using MV-Adapter in ComfyUI.,Apache License 2.0,1,5,23,6,2024-12-01
tahnok/colmi_r02_client,https://github.com/tahnok/colmi_r02_client,436,A python client + documentation for the Colmi R02 smart ring,The MIT License,0,6,19,6,2024-08-13
camel-ai/oasis,https://github.com/camel-ai/oasis,656,üèùÔ∏è OASIS: Open Agent Social Interaction Simulations with One Million Agents. https://oasis.camel-ai.org,Apache License 2.0,6,0,16,6,2024-11-13
MinishLab/model2vec,https://github.com/MinishLab/model2vec,1065,Fast State-of-the-Art Static Embeddings,The MIT License,6,0,7,6,2024-07-18
awslabs/multi-agent-orchestrator,https://github.com/awslabs/multi-agent-orchestrator,4186,Flexible and powerful framework for managing multiple AI agents and handling complex conversations,Apache License 2.0,1,4,33,5,2024-07-23
potpie-ai/potpie,https://github.com/potpie-ai/potpie,2533,Prompt-To-Agent : Create custom engineering agents for your codebase,Apache License 2.0,1,4,29,5,2024-08-12
business-science/ai-data-science-team,https://github.com/business-science/ai-data-science-team,1308,An AI-powered data science team of agents to help you perform common data science tasks 10X faster.,The MIT License,5,0,20,5,2024-12-11
NovaSky-AI/SkyThought,https://github.com/NovaSky-AI/SkyThought,2634,Sky-T1: Train your own O1 preview model within $450,Apache License 2.0,1,4,18,5,2025-01-09
awslabs/git-remote-s3,https://github.com/awslabs/git-remote-s3,547,,Apache License 2.0,5,0,5,5,2024-10-17
volfpeter/htmy,https://github.com/volfpeter/htmy,291,"Async, pure-Python rendering engine.",The MIT License,1,4,5,5,2024-10-03
genmoai/mochi,https://github.com/genmoai/mochi,2916,The best OSS video generation models,Apache License 2.0,4,0,49,4,2024-09-11
CatchTheTornado/text-extract-api,https://github.com/CatchTheTornado/text-extract-api,2375,"Document (PDF, Word, PPTX ...) extraction and parse API using state of the art modern OCRs + Ollama supported models. Anonymize documents. Remove PII. Convert any document or picture to structured JSON or Markdown",The MIT License,2,2,42,4,2024-10-23
ucbepic/docetl,https://github.com/ucbepic/docetl,1673,A system for agentic LLM-powered data processing and ETL,The MIT License,1,3,36,4,2024-07-09
cyclotruc/gitingest,https://github.com/cyclotruc/gitingest,6186,Replace 'hub' with 'ingest' in any github url to get a prompt-friendly extract of a codebase ,The MIT License,0,4,32,4,2024-11-29
multimodal-art-projection/YuE,https://github.com/multimodal-art-projection/YuE,3862,"YuE: Open Full-song Music Generation Foundation Model, something similar to Suno.ai but open",Apache License 2.0,1,3,30,4,2025-01-23
lastmile-ai/mcp-agent,https://github.com/lastmile-ai/mcp-agent,492,Build effective agents using Model Context Protocol and simple workflow patterns,Apache License 2.0,0,4,11,4,2024-12-18
martinpacesa/BindCraft,https://github.com/martinpacesa/BindCraft,445,User friendly and accurate binder design pipeline,The MIT License,2,2,7,4,2024-09-18
fan-ziqi/robot_lab,https://github.com/fan-ziqi/robot_lab,297,"RL Extension Library for Robots, Based on IsaacLab.",Apache License 2.0,4,0,1,4,2024-07-06
filipstrand/mflux,https://github.com/filipstrand/mflux,1211,A MLX port of FLUX based on the Huggingface Diffusers implementation.,The MIT License,3,0,21,3,2024-08-10
shun-liang/yt2doc,https://github.com/shun-liang/yt2doc,313,"YouTube, Apple Podcasts (and more) to readable Markdown.",The MIT License,1,2,12,3,2024-09-06
yeonholee50/AmpyFin,https://github.com/yeonholee50/AmpyFin,369,Machine learning trading system that trades while also training.,The MIT License,0,3,11,3,2024-09-25
Azzedde/paper_to_podcast,https://github.com/Azzedde/paper_to_podcast,470,"A very quick project that transforms research papers into engaging three-person discussions, offering an intuitive and thought-provoking listening experience. Perfect for podcast enthusiasts seeking a fresh way to explore academic content.",Apache License 2.0,0,3,4,3,2024-10-27
Kaliiiiiiiiii-Vinyzu/patchright-python,https://github.com/Kaliiiiiiiiii-Vinyzu/patchright-python,247,Undetected Python version of the Playwright testing and automation library. ,Apache License 2.0,1,2,1,3,2024-11-02
souzatharsis/podcastfy,https://github.com/souzatharsis/podcastfy,3182,An Open Source Python alternative to NotebookLM's podcast feature: Transforming Multimodal Content into Captivating Multilingual Audio Conversations with GenAI,Apache License 2.0,2,0,82,2,2024-09-30
gusye1234/nano-graphrag,https://github.com/gusye1234/nano-graphrag,2414,"A simple, easy-to-hack GraphRAG implementation",The MIT License,1,1,58,2,2024-07-25
AnswerDotAI/byaldi,https://github.com/AnswerDotAI/byaldi,733,Use late-interaction multi-modal models such as ColPali in just a few lines of code.,Apache License 2.0,1,1,31,2,2024-09-04
chonkie-ai/chonkie,https://github.com/chonkie-ai/chonkie,2581,ü¶õ CHONK your texts with Chonkie ‚ú® - The no-nonsense RAG chunking library,The MIT License,1,1,18,2,2024-11-01
giuseppe99barchetta/SuggestArr,https://github.com/giuseppe99barchetta/SuggestArr,425,"Effortlessly request recommended movies, TV shows and anime to Jellyseer/Overseer based on your recently watched content on Jellyfin, Plex or Emby‚Äîlet SuggestArr handle it all automatically, keeping your library fresh with new and exciting content!",The MIT License,2,0,17,2,2024-10-14
sentient-engineering/sentient,https://github.com/sentient-engineering/sentient,512,the framework/ sdk that lets you build browser controlling agents in 3 lines of code. join chat @ https://discord.gg/umgnyQU2K8,The MIT License,2,0,16,2,2024-09-01
Francis-Rings/StableAnimator,https://github.com/Francis-Rings/StableAnimator,1142,"We present StableAnimator, the first end-to-end ID-preserving video diffusion framework, which synthesizes high-quality videos without any post-processing, conditioned on a reference image and a sequence of poses.",The MIT License,0,2,13,2,2024-11-26
fpgmaas/cookiecutter-uv,https://github.com/fpgmaas/cookiecutter-uv,673,A modern cookiecutter template for Python projects that use uv for dependency management ,The MIT License,2,0,11,2,2024-09-02
FoundationVision/FlashVideo,https://github.com/FoundationVision/FlashVideo,326,FlashVideo:Flowing Fidelity to Detail for Efficient High-Resolution Video Generation,Apache License 2.0,0,2,10,2,2025-02-07
kennethreitz/simplemind,https://github.com/kennethreitz/simplemind,468,Python API client for AI providers that intends to replace LangChain and LangGraph for most common use cases.,Apache License 2.0,0,2,9,2,2024-10-28
wanghao9610/OV-DINO,https://github.com/wanghao9610/OV-DINO,289,Official implementation of OV-DINO: Unified Open-Vocabulary Detection with Language-Aware Selective Fusion,Apache License 2.0,1,1,6,2,2024-07-10
jahwag/ClaudeSync,https://github.com/jahwag/ClaudeSync,469,ClaudeSync is a Python tool that automates the synchronization of local files with Claude.ai Projects,The MIT License,2,0,5,2,2024-07-16
harsxv/tinystatus,https://github.com/harsxv/tinystatus,1519,Tiny status page generated by a Python script,The MIT License,0,2,4,2,2024-09-03
bowang-lab/MedRAX,https://github.com/bowang-lab/MedRAX,441,MedRAX: Medical Reasoning Agent for Chest X-ray,Apache License 2.0,0,2,3,2,2025-02-06
huggingface/smolagents,https://github.com/huggingface/smolagents,11205,ü§ó smolagents: a barebones library for agents. Agents write python code to call tools and orchestrate other agents.,Apache License 2.0,1,0,164,1,2024-12-05
deepseek-ai/DeepSeek-V3,https://github.com/deepseek-ai/DeepSeek-V3,86396,,The MIT License,1,0,124,1,2024-12-26
stacklok/codegate,https://github.com/stacklok/codegate,408,CodeGate: CodeGen Privacy and Security ,Apache License 2.0,1,0,98,1,2024-11-11
NVIDIA/nv-ingest,https://github.com/NVIDIA/nv-ingest,2532,"NVIDIA Ingest is an early access set of microservices for parsing hundreds of thousands of complex, messy unstructured PDFs and other enterprise documents into metadata and text to embed into retrieval systems.",Apache License 2.0,0,1,85,1,2024-08-22
jy0205/Pyramid-Flow,https://github.com/jy0205/Pyramid-Flow,2782,Code of Pyramidal Flow Matching for Efficient Video Generative Modeling,The MIT License,0,1,66,1,2024-10-06
bespokelabsai/curator,https://github.com/bespokelabsai/curator,814,Synthetic Data curation for post-training and structured data extraction,Apache License 2.0,1,0,60,1,2024-10-28
a-r-r-o-w/finetrainers,https://github.com/a-r-r-o-w/finetrainers,860,Memory-optimized training scripts for video models based on Diffusers,Apache License 2.0,0,1,47,1,2024-09-25
lmstudio-ai/venvstacks,https://github.com/lmstudio-ai/venvstacks,228,Virtual environment stacks for Python,The MIT License,1,0,46,1,2024-10-02
Lightricks/LTX-Video,https://github.com/Lightricks/LTX-Video,2854,Official repository for LTX-Video,Apache License 2.0,1,0,34,1,2024-11-20
Yuanshi9815/OminiControl,https://github.com/Yuanshi9815/OminiControl,1210,A minimal and universal controller for FLUX.1.,Apache License 2.0,1,0,33,1,2024-11-17
remsky/Kokoro-FastAPI,https://github.com/remsky/Kokoro-FastAPI,1597,"Dockerized FastAPI wrapper for Kokoro-82M text-to-speech model w/CPU ONNX and NVIDIA GPU PyTorch support, handling, and auto-stitching",Apache License 2.0,0,1,21,1,2024-12-30
clemlesne/scrape-it-now,https://github.com/clemlesne/scrape-it-now,510,Web scraper made for AI and simplicity in mind. It runs as a CLI that can be parallelized and outputs high-quality markdown content.,Apache License 2.0,0,1,16,1,2024-08-15
santinic/audiblez,https://github.com/santinic/audiblez,1668,Generate audiobooks from e-books,The MIT License,1,0,13,1,2025-01-14
magic-research/Sa2VA,https://github.com/magic-research/Sa2VA,884,üî• Sa2VA: Marrying SAM2 with LLaVA for Dense Grounded Understanding of Images and Videos,Apache License 2.0,0,1,13,1,2025-01-06
huggingface/picotron,https://github.com/huggingface/picotron,731,Minimalistic 4D-parallelism distributed training framework for education purpose,Apache License 2.0,1,0,8,1,2024-09-18
MinishLab/semhash,https://github.com/MinishLab/semhash,525,Fast Semantic Text Deduplication,The MIT License,1,0,5,1,2024-10-13
itsOwen/CyberScraper-2077,https://github.com/itsOwen/CyberScraper-2077,1593,"A Powerful web scraper powered by LLM | OpenAI, Gemini & Ollama",The MIT License,0,1,2,1,2024-08-17
Goldziher/kreuzberg,https://github.com/Goldziher/kreuzberg,1254,"A text extraction library supporting PDFs, images, office documents and more",The MIT License,0,1,2,1,2025-01-31
lucidrains/nGPT-pytorch,https://github.com/lucidrains/nGPT-pytorch,273,"Quick implementation of nGPT, learning entirely on the hypersphere, from NvidiaAI",The MIT License,1,0,1,1,2024-10-08
iamarunbrahma/vision-parse,https://github.com/iamarunbrahma/vision-parse,268,Parse PDFs into markdown using Vision LLMs,The MIT License,1,0,1,1,2024-12-16
NVIDIA/Star-Attention,https://github.com/NVIDIA/Star-Attention,357,Efficient LLM Inference over Long Sequences,Apache License 2.0,1,0,0,1,2024-11-19
FunAudioLLM/CosyVoice,https://github.com/FunAudioLLM/CosyVoice,10810,"Multi-lingual large voice generation model, providing inference, training and deployment full-stack ability.",Apache License 2.0,0,0,542,0,2024-07-03
browser-use/browser-use,https://github.com/browser-use/browser-use,29883,Make websites accessible for AI agents,The MIT License,0,0,291,0,2024-10-31
cocktailpeanut/fluxgym,https://github.com/cocktailpeanut/fluxgym,1998,Dead simple FLUX LoRA training UI with LOW VRAM support,The MIT License,0,0,277,0,2024-09-05
kvcache-ai/ktransformers,https://github.com/kvcache-ai/ktransformers,10379,A Flexible Framework for Experiencing Cutting-edge LLM Inference Optimizations,Apache License 2.0,0,0,260,0,2024-07-26
MadcowD/ell,https://github.com/MadcowD/ell,5614,A language model programming library.,The MIT License,0,0,178,0,2024-07-22
huggingface/open-r1,https://github.com/huggingface/open-r1,20695,Fully open reproduction of DeepSeek-R1,Apache License 2.0,0,0,177,0,2025-01-24
black-forest-labs/flux,https://github.com/black-forest-labs/flux,20292,Official inference repo for FLUX.1 models,Apache License 2.0,0,0,155,0,2024-08-01
browser-use/web-ui,https://github.com/browser-use/web-ui,7386,Run AI Agent in your browser.,The MIT License,0,0,153,0,2025-01-02
deepseek-ai/Janus,https://github.com/deepseek-ai/Janus,16039,Janus-Series: Unified Multimodal Understanding and Generation Models,The MIT License,0,0,141,0,2024-10-18
kijai/ComfyUI-CogVideoXWrapper,https://github.com/kijai/ComfyUI-CogVideoXWrapper,1379,,Apache License 2.0,0,0,134,0,2024-08-05
microsoft/TRELLIS,https://github.com/microsoft/TRELLIS,7700,"Official repo for paper ""Structured 3D Latents for Scalable and Versatile 3D Generation"".",The MIT License,0,0,132,0,2024-12-02
Kwai-Kolors/Kolors,https://github.com/Kwai-Kolors/Kolors,4190,Kolors Team,Apache License 2.0,0,0,130,0,2024-07-05
XLabs-AI/x-flux-comfyui,https://github.com/XLabs-AI/x-flux-comfyui,1347,,Apache License 2.0,0,0,113,0,2024-08-12
antgroup/echomimic,https://github.com/antgroup/echomimic,3577,EchoMimic: Lifelike Audio-Driven Portrait Animations through Editable Landmark Conditioning,Apache License 2.0,0,0,107,0,2024-07-03
XLabs-AI/x-flux,https://github.com/XLabs-AI/x-flux,1883,,Apache License 2.0,0,0,107,0,2024-08-05
StartHua/Comfyui_CXH_joy_caption,https://github.com/StartHua/Comfyui_CXH_joy_caption,509,Recommended based on comfyui node pictures:Joy_caption + MiniCPMv2_6-prompt-generator + florence2,Apache License 2.0,0,0,105,0,2024-08-14
kijai/ComfyUI-FluxTrainer,https://github.com/kijai/ComfyUI-FluxTrainer,683,,Apache License 2.0,0,0,90,0,2024-08-15
Zyphra/Zonos,https://github.com/Zyphra/Zonos,5035,"Zonos-v0.1 is a leading open-weight text-to-speech model trained on more than 200k hours of varied multilingual speech, delivering expressiveness and quality on par with‚Äîor even surpassing‚Äîtop TTS providers.",Apache License 2.0,0,0,89,0,2025-02-07
city96/ComfyUI-GGUF,https://github.com/city96/ComfyUI-GGUF,1474,GGUF Quantization support for native ComfyUI models,Apache License 2.0,0,0,89,0,2024-08-15
OpenSPG/KAG,https://github.com/OpenSPG/KAG,5279,KAG is a logical form-guided reasoning and retrieval framework based on OpenSPG engine and LLMs.  It is used to build logical reasoning and factual Q&A solutions for professional domain knowledge bases. It can effectively overcome the shortcomings of the traditional RAG vector similarity calculation model.,Apache License 2.0,0,0,87,0,2024-09-21
kijai/ComfyUI-LivePortraitKJ,https://github.com/kijai/ComfyUI-LivePortraitKJ,1835,ComfyUI nodes for LivePortrait,The MIT License,0,0,87,0,2024-07-04
smthemex/ComfyUI_EchoMimic,https://github.com/smthemex/ComfyUI_EchoMimic,540,You can using EchoMimic in ComfyUI,Apache License 2.0,0,0,87,0,2024-07-13
Peterande/D-FINE,https://github.com/Peterande/D-FINE,1489,D-FINE: Redefine Regression Task of DETRs as Fine-grained Distribution Refinement  [ICLR 2025 Spotlight],Apache License 2.0,0,0,83,0,2024-08-12
Huanshere/VideoLingo,https://github.com/Huanshere/VideoLingo,11234,"Netflix-level subtitle cutting, translation, alignment, and even dubbing - one-click fully automated AI video subtitle team | NetflixÁ∫ßÂ≠óÂπïÂàáÂâ≤„ÄÅÁøªËØë„ÄÅÂØπÈΩê„ÄÅÁîöËá≥Âä†‰∏äÈÖçÈü≥Ôºå‰∏ÄÈîÆÂÖ®Ëá™Âä®ËßÜÈ¢ëÊê¨ËøêAIÂ≠óÂπïÁªÑ",Apache License 2.0,0,0,81,0,2024-08-09
deepseek-ai/DeepSeek-VL2,https://github.com/deepseek-ai/DeepSeek-VL2,3747,DeepSeek-VL2: Mixture-of-Experts Vision-Language Models for Advanced Multimodal Understanding,The MIT License,0,0,72,0,2024-12-13
jwohlwend/boltz,https://github.com/jwohlwend/boltz,1592,Official repository for the Boltz-1 biomolecular interaction model,The MIT License,0,0,72,0,2024-11-17
intel/AI-Playground,https://github.com/intel/AI-Playground,364,"AI PC starter app for doing AI image creation, image stylizing, and chatbot on a PC powered by an Intel¬Æ Arc‚Ñ¢ GPU.",The MIT License,0,0,72,0,2024-07-10
bytedance/LatentSync,https://github.com/bytedance/LatentSync,2549,Taming Stable Diffusion for Lip Sync!,Apache License 2.0,0,0,68,0,2024-12-11
airtai/fastagency,https://github.com/airtai/fastagency,392,The fastest way to bring multi-agent workflows to production.,Apache License 2.0,0,0,64,0,2024-07-17
huggingface/speech-to-speech,https://github.com/huggingface/speech-to-speech,3753,Speech To Speech: an effort for an open-sourced and modular GPT4-o,Apache License 2.0,0,0,62,0,2024-08-07
lllyasviel/Paints-UNDO,https://github.com/lllyasviel/Paints-UNDO,3738,Understand Human Behavior to Align True Needs,Apache License 2.0,0,0,61,0,2024-07-07
chengzeyi/Comfy-WaveSpeed,https://github.com/chengzeyi/Comfy-WaveSpeed,760,"[WIP] The all in one inference optimization solution for ComfyUI, universal, flexible, and fast.",The MIT License,0,0,61,0,2024-11-27
THUDM/CodeGeeX4,https://github.com/THUDM/CodeGeeX4,1797,"CodeGeeX4-ALL-9B, a versatile model for all AI software development scenarios, including code completion, code interpreter, web search, function calling, repository-level Q&A and much more.",Apache License 2.0,0,0,60,0,2024-07-03
jishengpeng/WavTokenizer,https://github.com/jishengpeng/WavTokenizer,1026,SOTA discrete acoustic codec models with 40 tokens per second for audio language modeling ,The MIT License,0,0,57,0,2024-08-29
tdrussell/diffusion-pipe,https://github.com/tdrussell/diffusion-pipe,520,A pipeline parallel training script for diffusion models.,The MIT License,0,0,57,0,2024-08-03
Shakker-Labs/ComfyUI-IPAdapter-Flux,https://github.com/Shakker-Labs/ComfyUI-IPAdapter-Flux,268,,Apache License 2.0,0,0,57,0,2024-11-22
NexaAI/nexa-sdk,https://github.com/NexaAI/nexa-sdk,4363,"Nexa SDK is a comprehensive toolkit for supporting GGML and ONNX models. It supports text generation, image generation, vision-language models (VLM), Audio Language Model, auto-speech-recognition (ASR), and text-to-speech (TTS) capabilities.",Apache License 2.0,0,0,56,0,2024-08-16
xjdr-alt/entropix,https://github.com/xjdr-alt/entropix,3317,Entropy Based Sampling and Parallel CoT Decoding ,Apache License 2.0,0,0,56,0,2024-10-03
antgroup/echomimic_v2,https://github.com/antgroup/echomimic_v2,2798,"EchoMimicV2: Towards Striking, Simplified, and Semi-Body Human Animation",Apache License 2.0,0,0,56,0,2024-11-20
Jiayi-Pan/TinyZero,https://github.com/Jiayi-Pan/TinyZero,10355,"Clean, minimal, accessible reproduction of DeepSeek R1-Zero",Apache License 2.0,0,0,55,0,2025-01-21
baaivision/Emu3,https://github.com/baaivision/Emu3,2002,Next-Token Prediction is All You Need,Apache License 2.0,0,0,54,0,2024-09-26
TheAiSingularity/graphrag-local-ollama,https://github.com/TheAiSingularity/graphrag-local-ollama,892,"Local models support for Microsoft's graphrag using ollama (llama3, mistral, gemma2 phi3)- LLM & Embedding extraction",The MIT License,0,0,52,0,2024-07-08
kijai/ComfyUI-MochiWrapper,https://github.com/kijai/ComfyUI-MochiWrapper,762,,Apache License 2.0,0,0,52,0,2024-10-23
severian42/GraphRAG-Local-UI,https://github.com/severian42/GraphRAG-Local-UI,1980,GraphRAG using Local LLMs - Features robust API and multiple apps for Indexing/Prompt Tuning/Query/Chat/Visualizing/Etc. This is meant to be the ultimate GraphRAG/KG local LLM app. ,The MIT License,0,0,51,0,2024-07-14
AgentOps-AI/AgentStack,https://github.com/AgentOps-AI/AgentStack,1667,The fastest way to build robust AI agents,The MIT License,0,0,51,0,2024-09-18
googleapis/python-genai,https://github.com/googleapis/python-genai,1016,Google Gen AI Python SDK provides an interface for developers to integrate Google's generative models into their Python applications.,Apache License 2.0,0,0,51,0,2024-12-06
THUDM/GLM-4-Voice,https://github.com/THUDM/GLM-4-Voice,2669,GLM-4-Voice | Á´ØÂà∞Á´Ø‰∏≠Ëã±ËØ≠Èü≥ÂØπËØùÊ®°Âûã,Apache License 2.0,0,0,49,0,2024-10-24
yerfor/MimicTalk,https://github.com/yerfor/MimicTalk,561,MimicTalk: Mimicking a personalized and expressive 3D talking face in minutes; NeurIPS 2024; Official code,The MIT License,0,0,49,0,2024-10-09
ictnlp/LLaMA-Omni,https://github.com/ictnlp/LLaMA-Omni,2809,"LLaMA-Omni is a low-latency and high-quality end-to-end speech interaction model built upon Llama-3.1-8B-Instruct, aiming to achieve speech capabilities at the GPT-4o level.",Apache License 2.0,0,0,48,0,2024-09-10
fudan-generative-vision/hallo2,https://github.com/fudan-generative-vision/hallo2,3477,Hallo2: Long-Duration and High-Resolution Audio-driven Portrait Image Animation,The MIT License,0,0,44,0,2024-10-16
showlab/computer_use_ootb,https://github.com/showlab/computer_use_ootb,1311,Out-of-the-box (OOTB) GUI Agent for Windows and macOS,Apache License 2.0,0,0,43,0,2024-10-23
SamuelSchmidgall/AgentLaboratory,https://github.com/SamuelSchmidgall/AgentLaboratory,3543,Agent Laboratory is an end-to-end autonomous research workflow meant to assist you as the human researcher toward implementing your research ideas,The MIT License,0,0,42,0,2025-01-08
aigc-apps/CogVideoX-Fun,https://github.com/aigc-apps/CogVideoX-Fun,645,üìπ A more flexible CogVideoX that can generate videos at any resolution and creates videos from images. ,Apache License 2.0,0,0,42,0,2024-09-10
NVlabs/Sana,https://github.com/NVlabs/Sana,3391,SANA: Efficient High-Resolution Image Synthesis with Linear Diffusion Transformer,Apache License 2.0,0,0,39,0,2024-10-11
thewh1teagle/kokoro-onnx,https://github.com/thewh1teagle/kokoro-onnx,1606,TTS with kokoro and onnx runtime,The MIT License,0,0,39,0,2025-01-03
showlab/Show-o,https://github.com/showlab/Show-o,1217,"[ICLR 2025] Repository for Show-o, One Single Transformer to Unify Multimodal Understanding and Generation.",Apache License 2.0,0,0,38,0,2024-08-09
ziyc/drivestudio,https://github.com/ziyc/drivestudio,717,A 3DGS framework for omni urban scene reconstruction and simulation.,The MIT License,0,0,38,0,2024-08-29
cvg/NoPoSplat,https://github.com/cvg/NoPoSplat,646,"No Pose, No Problem: Surprisingly Simple 3D Gaussian Splats from Sparse Unposed Images",The MIT License,0,0,38,0,2024-10-28
kijai/ComfyUI-KwaiKolorsWrapper,https://github.com/kijai/ComfyUI-KwaiKolorsWrapper,578,Diffusers wrapper to run Kwai-Kolors model,Apache License 2.0,0,0,37,0,2024-07-06
gpt-omni/mini-omni,https://github.com/gpt-omni/mini-omni,3151,"open-source multimodal large language model that can hear, talk while thinking. Featuring real-time end-to-end speech input and streaming audio output conversational capabilities. ",The MIT License,0,0,36,0,2024-08-27
WZH0120/SAM2-UNet,https://github.com/WZH0120/SAM2-UNet,229,SAM2-UNet: Segment Anything 2 Makes Strong Encoder for Natural and Medical Image Segmentation,Apache License 2.0,0,0,36,0,2024-08-15
SuperMedIntel/Medical-SAM2,https://github.com/SuperMedIntel/Medical-SAM2,593,Medical SAM 2: Segment Medical Images As Video Via Segment Anything Model 2,Apache License 2.0,0,0,35,0,2024-07-30
smthemex/ComfyUI_Sonic,https://github.com/smthemex/ComfyUI_Sonic,479,"Sonic is a method about ' Shifting Focus to Global Audio Perception in Portrait Animation',you can use it in comfyUI",The MIT License,0,0,35,0,2025-02-07
alimama-creative/SDXL_EcomID_ComfyUI,https://github.com/alimama-creative/SDXL_EcomID_ComfyUI,384,,Apache License 2.0,0,0,35,0,2024-10-22
virattt/ai-hedge-fund,https://github.com/virattt/ai-hedge-fund,8687,An AI Hedge Fund Team,The MIT License,0,0,34,0,2024-11-29
simplescaling/s1,https://github.com/simplescaling/s1,5486,s1: Simple test-time scaling,Apache License 2.0,0,0,34,0,2025-02-01
kijai/ComfyUI-segment-anything-2,https://github.com/kijai/ComfyUI-segment-anything-2,766,ComfyUI nodes to use segment-anything-2,Apache License 2.0,0,0,34,0,2024-07-30
LTH14/mar,https://github.com/LTH14/mar,1285,PyTorch implementation of MAR+DiffLoss https://arxiv.org/abs/2406.11838,The MIT License,0,0,32,0,2024-07-24
dailenson/One-DM,https://github.com/dailenson/One-DM,344, Official Code for ECCV 2024 paper ‚Äî One-Shot Diffusion Mimicker for Handwritten Text Generation,The MIT License,0,0,32,0,2024-07-15
Drexubery/ViewCrafter,https://github.com/Drexubery/ViewCrafter,1166,"Official implementation of ""ViewCrafter: Taming Video Diffusion Models for High-fidelity Novel View Synthesis""",Apache License 2.0,0,0,31,0,2024-07-22
blorm-network/ZerePy,https://github.com/blorm-network/ZerePy,544,ZerePy an open-source framework for AI agents written in Python,The MIT License,0,0,31,0,2024-11-21
Azure-Samples/aisearch-openai-rag-audio,https://github.com/Azure-Samples/aisearch-openai-rag-audio,365,A simple example implementation of the VoiceRAG pattern to power interactive voice generative AI experiences using RAG with Azure AI Search and Azure OpenAI's gpt-4o-realtime-preview model. ,The MIT License,0,0,31,0,2024-09-19
Storia-AI/sage,https://github.com/Storia-AI/sage,1178,Chat with any codebase in under two minutes | Fully local or via third-party APIs,Apache License 2.0,0,0,30,0,2024-08-23
Lightricks/ComfyUI-LTXVideo,https://github.com/Lightricks/ComfyUI-LTXVideo,728,LTX-Video Support for ComfyUI,Apache License 2.0,0,0,30,0,2024-11-21
kijai/ComfyUI-PyramidFlowWrapper,https://github.com/kijai/ComfyUI-PyramidFlowWrapper,352,,The MIT License,0,0,30,0,2024-10-10
miaoshouai/ComfyUI-Miaoshouai-Tagger,https://github.com/miaoshouai/ComfyUI-Miaoshouai-Tagger,336,,The MIT License,0,0,30,0,2024-07-13
gpt-omni/mini-omni2,https://github.com/gpt-omni/mini-omni2,1625,"Towards Open-source GPT-4o with Vision, Speech and Duplex Capabilities„ÄÇ",The MIT License,0,0,29,0,2024-10-14
agentica-project/deepscaler,https://github.com/agentica-project/deepscaler,1613,Democratizing Reinforcement Learning for LLMs,The MIT License,0,0,29,0,2025-01-26
wwbin2017/bailing,https://github.com/wwbin2017/bailing,605,ÁôæËÅÜ ÊòØ‰∏Ä‰∏™Á±ª‰ººGPT-4oÁöÑËØ≠Èü≥ÂØπËØùÊú∫Âô®‰∫∫ÔºåÈÄöËøáASR+LLM+TTSÂÆûÁé∞ÔºåÈõÜÊàêDeepSeek R1Á≠â‰ºòÁßÄÂ§ßÊ®°ÂûãÔºåÊó∂Âª∂‰ΩéËá≥800msÔºå‰ΩéÈÖçÁΩÆ‰πüÂèØËøêË°åÔºåÊîØÊåÅÊâìÊñ≠,The MIT License,0,0,29,0,2024-08-25
linyqh/NarratoAI,https://github.com/linyqh/NarratoAI,3777,Âà©Áî®AIÂ§ßÊ®°ÂûãÔºå‰∏ÄÈîÆËß£ËØ¥Âπ∂Ââ™ËæëËßÜÈ¢ëÔºõ Using AI models to automatically provide commentary and edit videos with a single click.,The MIT License,0,0,28,0,2024-08-12
hkust-nlp/simpleRL-reason,https://github.com/hkust-nlp/simpleRL-reason,2798,This is a replicate of DeepSeek-R1-Zero and DeepSeek-R1 training on small models with limited data,The MIT License,0,0,28,0,2025-01-25
etched-ai/open-oasis,https://github.com/etched-ai/open-oasis,1742,Inference script for Oasis 500M,The MIT License,0,0,28,0,2024-10-31
codegen-sh/codegen-sdk,https://github.com/codegen-sh/codegen-sdk,256,"Scriptable interface to a powerful, multi-lingual language server built on top of Tree-sitter",Apache License 2.0,0,0,28,0,2025-01-21
crestalnetwork/intentkit,https://github.com/crestalnetwork/intentkit,5100,"An open and fair framework for everyone to build AI agents equipped with powerful skills. Launch your agent, improve the world, your wallet, or both!",The MIT License,0,0,26,0,2024-12-09
lmstudio-ai/mlx-engine,https://github.com/lmstudio-ai/mlx-engine,401,üëæüçé Apple MLX engine for LM Studio,The MIT License,0,0,26,0,2024-10-07
turbo-llm/turbo-alignment,https://github.com/turbo-llm/turbo-alignment,379,Library for industrial alignment.,Apache License 2.0,0,0,26,0,2024-07-20
THUDM/LongWriter,https://github.com/THUDM/LongWriter,1599,"[ICLR 2025] LongWriter: Unleashing 10,000+ Word Generation from Long Context LLMs",Apache License 2.0,0,0,25,0,2024-08-12
FoundationVision/Infinity,https://github.com/FoundationVision/Infinity,963,Infinity ‚àû : Scaling Bitwise AutoRegressive Modeling for High-Resolution Image Synthesis,The MIT License,0,0,25,0,2024-11-29
apple/ml-mdm,https://github.com/apple/ml-mdm,476,Train high-quality text-to-image diffusion models in a data & compute efficient manner,The MIT License,0,0,25,0,2024-08-02
stepfun-ai/Step-Audio,https://github.com/stepfun-ai/Step-Audio,1937,,Apache License 2.0,0,0,24,0,2025-02-11
PKU-YuanGroup/ConsisID,https://github.com/PKU-YuanGroup/ConsisID,586,Identity-Preserving Text-to-Video Generation by Frequency Decomposition,Apache License 2.0,0,0,24,0,2024-11-15
whyhow-ai/knowledge-table,https://github.com/whyhow-ai/knowledge-table,503,Knowledge Table is an open-source package designed to simplify extracting and exploring structured data from unstructured documents.,The MIT License,0,0,24,0,2024-10-05
modelscope/ClearerVoice-Studio,https://github.com/modelscope/ClearerVoice-Studio,2248,"An AI-Powered Speech Processing Toolkit and Open Source SOTA Pretrained Models, Supporting Speech Enhancement, Separation, and Target Speaker Extraction, etc.",Apache License 2.0,0,0,23,0,2024-11-12
QiuYannnn/Local-File-Organizer,https://github.com/QiuYannnn/Local-File-Organizer,2031,"An AI-powered file management tool that ensures privacy by organizing local texts, images. Using Llama3.2 3B and Llava v1.6 models with the Nexa SDK, it intuitively scans, restructures, and organizes files for quick, seamless access and easy retrieval.",The MIT License,0,0,23,0,2024-09-21
video-db/Director,https://github.com/video-db/Director,752,AI video agents framework for next-gen video interactions and workflows.,The MIT License,0,0,23,0,2024-10-14
nolenroyalty/global-capslock,https://github.com/nolenroyalty/global-capslock,454,A CaPsLOCK KeY shaReD by thE WOrLD,The MIT License,0,0,23,0,2025-02-01
erwold/qwen2vl-flux,https://github.com/erwold/qwen2vl-flux,425,,The MIT License,0,0,23,0,2024-11-25
tzador/makedown,https://github.com/tzador/makedown,309,Organise your shell scripts within executable markdown files,The MIT License,0,0,23,0,2024-10-13
VectorSpaceLab/Video-XL,https://github.com/VectorSpaceLab/Video-XL,233,üî•üî•First-ever hour scale video understanding models,Apache License 2.0,0,0,23,0,2024-09-20
wenqsun/DimensionX,https://github.com/wenqsun/DimensionX,1192,DimensionX: Create Any 3D and 4D Scenes from a Single Image with Controllable Video Diffusion,Apache License 2.0,0,0,22,0,2024-11-07
zhentingqi/rStar,https://github.com/zhentingqi/rStar,890,,The MIT License,0,0,22,0,2024-08-07
jdh-algo/JoyVASA,https://github.com/jdh-algo/JoyVASA,663,Diffusion-based Portrait and Animal Animation,The MIT License,0,0,22,0,2024-11-14
microsoft/WindowsAgentArena,https://github.com/microsoft/WindowsAgentArena,588,Windows Agent Arena (WAA) ü™ü is a scalable OS platform for testing and benchmarking of multi-modal AI agents.,The MIT License,0,0,22,0,2024-07-29
FireRedTeam/FireRedASR,https://github.com/FireRedTeam/FireRedASR,561,"FireRedASR is a family of open-source industrial-grade ASR models supporting Mandarin, Chinese dialects and English, achieving a new SOTA on public Mandarin ASR benchmarks, while also offering outstanding singing lyrics recognition capability.",Apache License 2.0,0,0,22,0,2025-01-24
hao-ai-lab/FastVideo,https://github.com/hao-ai-lab/FastVideo,1080,FastVideo is a lightweight framework for accelerating large video diffusion models.,Apache License 2.0,0,0,21,0,2024-10-24
VisionRush/DeepFakeDefenders,https://github.com/VisionRush/DeepFakeDefenders,619,Image forgery recognition algorithm,Apache License 2.0,0,0,21,0,2024-08-31
open-thought/reasoning-gym,https://github.com/open-thought/reasoning-gym,422,procedural reasoning datasets,Apache License 2.0,0,0,21,0,2025-01-23
HelloVision/ComfyUI_HelloMeme,https://github.com/HelloVision/ComfyUI_HelloMeme,331,Official comfyui repository of Hellomeme,The MIT License,0,0,21,0,2024-11-05
fpgaminer/joycaption,https://github.com/fpgaminer/joycaption,328,"JoyCaption is an image captioning Visual Language Model (VLM) being built from the ground up as a free, open, and uncensored model for the community to use in training Diffusion models.",Apache License 2.0,0,0,21,0,2024-10-12
thu-ml/RoboticsDiffusionTransformer,https://github.com/thu-ml/RoboticsDiffusionTransformer,895,RDT-1B: a Diffusion Foundation Model for Bimanual Manipulation,The MIT License,0,0,20,0,2024-10-07
querylab/lazywarden,https://github.com/querylab/lazywarden,700,Automatic Bitwarden Backup,The MIT License,0,0,20,0,2024-09-20
john-mnz/ComfyUI-Inspyrenet-Rembg,https://github.com/john-mnz/ComfyUI-Inspyrenet-Rembg,448,"ComfyUI node for background removal, implementing InSPyreNet the best method up to date",The MIT License,0,0,20,0,2024-07-17
ShihuaHuang95/DEIM,https://github.com/ShihuaHuang95/DEIM,289,DEIM: DETR with Improved Matching for Fast Convergence,Apache License 2.0,0,0,20,0,2024-11-18
aredden/flux-fp8-api,https://github.com/aredden/flux-fp8-api,247,"Flux diffusion model implementation using quantized fp8 matmul & remaining layers use faster half precision accumulate, which is ~2x faster on consumer devices.",Apache License 2.0,0,0,20,0,2024-08-05
stepfun-ai/Step-Video-T2V,https://github.com/stepfun-ai/Step-Video-T2V,1464,,The MIT License,0,0,19,0,2025-02-08
lotus-data/lotus,https://github.com/lotus-data/lotus,1060,LOTUS: A semantic query engine for fast and easy LLM-powered data processing,The MIT License,0,0,19,0,2024-07-16
TTPlanetPig/Comfyui_TTP_Toolset,https://github.com/TTPlanetPig/Comfyui_TTP_Toolset,519,for tile the image for advanced control or modification ,The MIT License,0,0,19,0,2024-08-17
IamCreateAI/Ruyi-Models,https://github.com/IamCreateAI/Ruyi-Models,485,,Apache License 2.0,0,0,19,0,2024-12-16
if-ai/ComfyUI-IF_Trellis,https://github.com/if-ai/ComfyUI-IF_Trellis,381,"ComfyUI TRELLIS is a large 3D asset generation in various formats, such as Radiance Fields, 3D Gaussians, and meshes. The cornerstone of TRELLIS is a unified Structured LATent (SLAT) representation that allows decoding to different output formats and Rectified Flow Transformers tailored for SLAT as the powerful backbones. ",The MIT License,0,0,19,0,2024-12-13
ictnlp/LLaVA-Mini,https://github.com/ictnlp/LLaVA-Mini,369,"LLaVA-Mini is a unified large multimodal model (LMM) that can support the understanding of images, high-resolution images, and videos in an efficient manner. ",Apache License 2.0,0,0,19,0,2025-01-07
kijai/ComfyUI-MMAudio,https://github.com/kijai/ComfyUI-MMAudio,252,,The MIT License,0,0,19,0,2024-12-10
hustvl/LightningDiT,https://github.com/hustvl/LightningDiT,250,[arXiv'25] Reconstruction vs. Generation: Taming Optimization Dilemma in Latent Diffusion Models,The MIT License,0,0,19,0,2025-01-01
StructuredLabs/preswald,https://github.com/StructuredLabs/preswald,1339,"üêµ Preswald is a full-stack platform for building, deploying, and managing interactive data applications. It brings ingestion, storage, transformation, and visualization into a simple SDK, minimizing complexity while maintaining flexibility for both prototyping and production-grade use cases.",Apache License 2.0,0,0,18,0,2024-12-14
HelloVision/HelloMeme,https://github.com/HelloVision/HelloMeme,566,The official HelloMeme GitHub site,The MIT License,0,0,18,0,2024-09-19
mks0601/ExAvatar_RELEASE,https://github.com/mks0601/ExAvatar_RELEASE,515,"Official PyTorch implementation of ""Expressive Whole-Body 3D Gaussian Avatar"", ECCV 2024.",The MIT License,0,0,18,0,2024-09-12
BHznJNs/InputShare,https://github.com/BHznJNs/InputShare,326,InputShare enables you to share the keyboard and mouse of your computer with an Android device via ADB in wired / wireless way.,Apache License 2.0,0,0,18,0,2024-10-21
replicate/cog-flux,https://github.com/replicate/cog-flux,323,Cog inference for flux models,Apache License 2.0,0,0,18,0,2024-07-29
thousandbrainsproject/tbp.monty,https://github.com/thousandbrainsproject/tbp.monty,263,Monty is a sensorimotor learning framework based on the thousand brains theory of the neocortex.,The MIT License,0,0,18,0,2024-11-13
usefulsensors/moonshine,https://github.com/usefulsensors/moonshine,2567,Fast and accurate automatic speech recognition (ASR) for edge devices,The MIT License,0,0,17,0,2024-10-04
harry0703/AudioNotes,https://github.com/harry0703/AudioNotes,1457,Âø´ÈÄüÊèêÂèñÈü≥ËßÜÈ¢ëÂÜÖÂÆπÔºåÊï¥ÁêÜÊàê‰∏Ä‰ªΩÁªìÊûÑÂåñÁöÑmarkdownÁ¨îËÆ∞,The MIT License,0,0,17,0,2024-07-19
Stability-AI/sd3.5,https://github.com/Stability-AI/sd3.5,980,,The MIT License,0,0,17,0,2024-10-09
chrishayuk/mcp-cli,https://github.com/chrishayuk/mcp-cli,578,,The MIT License,0,0,17,0,2024-11-30
kaibioinfo/ComfyUI_AdvancedRefluxControl,https://github.com/kaibioinfo/ComfyUI_AdvancedRefluxControl,439,,The MIT License,0,0,17,0,2024-11-22
getzep/graphiti,https://github.com/getzep/graphiti,2004,"Build and query dynamic, temporally-aware Knowledge Graphs",Apache License 2.0,0,0,16,0,2024-08-08
lucidrains/titans-pytorch,https://github.com/lucidrains/titans-pytorch,1084,"Unofficial implementation of Titans, SOTA memory for transformers, in Pytorch",The MIT License,0,0,16,0,2025-01-08
rhymes-ai/Allegro,https://github.com/rhymes-ai/Allegro,1045,Allegro is a powerful text-to-video model that generates high-quality videos up to 6 seconds at 15 FPS and 720p resolution from simple text input. ,Apache License 2.0,0,0,16,0,2024-10-16
IDEA-Research/DINO-X-API,https://github.com/IDEA-Research/DINO-X-API,863,DINO-X: The World's Top-Performing Vision Model for Open-World Object Detection and Understanding,Apache License 2.0,0,0,16,0,2024-11-20
PrimeIntellect-ai/prime,https://github.com/PrimeIntellect-ai/prime,656,"prime is a framework for efficient, globally distributed training of AI models over the internet.",Apache License 2.0,0,0,16,0,2024-09-11
allenzren/open-pi-zero,https://github.com/allenzren/open-pi-zero,647,Re-implementation of pi0 vision-language-action (VLA) model from Physical Intelligence ,The MIT License,0,0,16,0,2024-12-03
stephengpope/no-code-architects-toolkit,https://github.com/stephengpope/no-code-architects-toolkit,294,"The NCA Toolkit API eliminates monthly subscription fees by consolidating common API functionalities into a single FREE API. Designed for businesses, creators, and developers, it streamlines advanced media processing, including video editing and captioning, image transformations, cloud storage, and Python code execution.",The MIT License,0,0,16,0,2024-08-03
abus-aikorea/voice-pro,https://github.com/abus-aikorea/voice-pro,3283,"Comprehensive Gradio WebUI for audio processing, powered by Whisper engines (Whisper, Faster-Whisper, Whisper-Timestamped). Features Voice Changer(RVC), zero-shot Voice Cloning (E2, F5-TTS), YouTube downloading, vocal isolation(UVR5), Text-to-Speech (Edge-TTS), and multi-language translation. Perfect for content creators and developers.",The MIT License,0,0,15,0,2024-07-29
franciszzj/Leffa,https://github.com/franciszzj/Leffa,1099,Learning Flow Fields in Attention for Controllable Person Image Generation,The MIT License,0,0,15,0,2024-12-05
fudan-generative-vision/hallo3,https://github.com/fudan-generative-vision/hallo3,1058,Hallo3: Highly Dynamic and Realistic Portrait Image Animation with Diffusion Transformer Networks,The MIT License,0,0,15,0,2024-11-27
DepthAnything/Video-Depth-Anything,https://github.com/DepthAnything/Video-Depth-Anything,615,Video Depth Anything: Consistent Depth Estimation for Super-Long Videos,Apache License 2.0,0,0,15,0,2025-01-21
Alpha-VLLM/Lumina-Image-2.0,https://github.com/Alpha-VLLM/Lumina-Image-2.0,448,,Apache License 2.0,0,0,15,0,2025-01-25
explosion/spacy-layout,https://github.com/explosion/spacy-layout,412,"üìö Process PDFs, Word documents and more with spaCy",The MIT License,0,0,15,0,2024-11-17
Azure/co-op-translator,https://github.com/Azure/co-op-translator,333,"Easily generate multilingual translations for your project with a single command, powered by Azure AI Services.",The MIT License,0,0,15,0,2024-09-19
hustvl/Senna,https://github.com/hustvl/Senna,301,Bridging Large Vision-Language Models and End-to-End Autonomous Driving,Apache License 2.0,0,0,15,0,2024-10-29
Lucaria-Academy/Animate-X,https://github.com/Lucaria-Academy/Animate-X,301,[ICLR 2025] Animate-X - PyTorch Implementation,Apache License 2.0,0,0,15,0,2024-09-26
opendatalab/OmniDocBench,https://github.com/opendatalab/OmniDocBench,241,A Comprehensive Benchmark for Document Parsing and Evaluation,Apache License 2.0,0,0,15,0,2024-10-14
yanghb22-fdu/Hi3D-Official,https://github.com/yanghb22-fdu/Hi3D-Official,239,"[MM24] Official codes and datasets for ACM MM24 paper ""Hi3D: Pursuing High-Resolution Image-to-3D Generation with Video Diffusion Models"".",The MIT License,0,0,15,0,2024-08-30
grapeot/devin.cursorrules,https://github.com/grapeot/devin.cursorrules,4494,Magic to turn Cursor/Windsurf as 90% of Devin,The MIT License,0,0,14,0,2024-12-17
huggingface/smollm,https://github.com/huggingface/smollm,1885,Everything about the SmolLM2 and SmolVLM family of models ,Apache License 2.0,0,0,14,0,2024-11-04
qhjqhj00/MemoRAG,https://github.com/qhjqhj00/MemoRAG,1633,Empowering RAG with a memory-based data interface for all-purpose applications!,Apache License 2.0,0,0,14,0,2024-09-04
Eyeline-Research/Go-with-the-Flow,https://github.com/Eyeline-Research/Go-with-the-Flow,749,Motion-Controllable Video Diffusion via Warped Noise,Apache License 2.0,0,0,14,0,2025-01-09
cvg/depthsplat,https://github.com/cvg/depthsplat,677,DepthSplat: Connecting Gaussian Splatting and Depth,The MIT License,0,0,14,0,2024-10-17
Time-MoE/Time-MoE,https://github.com/Time-MoE/Time-MoE,449,"[ICLR 2025 Spotlight] Official implementation of ""Time-MoE: Billion-Scale Time Series Foundation Models with Mixture of Experts""",Apache License 2.0,0,0,14,0,2024-09-22
mit-han-lab/hart,https://github.com/mit-han-lab/hart,418,HART: Efficient Visual Generation with Hybrid Autoregressive Transformer,The MIT License,0,0,14,0,2024-10-08
nftblackmagic/catvton-flux,https://github.com/nftblackmagic/catvton-flux,400,,The MIT License,0,0,14,0,2024-11-24
zhangfaen/finetune-Qwen2-VL,https://github.com/zhangfaen/finetune-Qwen2-VL,318,,The MIT License,0,0,14,0,2024-09-04
bytedance/tarsier,https://github.com/bytedance/tarsier,282,"Tarsier -- a family of large-scale video-language models, which is designed to generate high-quality video descriptions , together with good capability of general video understanding. ",Apache License 2.0,0,0,14,0,2024-07-05
om-ai-lab/OmAgent,https://github.com/om-ai-lab/OmAgent,1761,Build multimodal language agents for fast prototype and production,Apache License 2.0,0,0,13,0,2024-07-04
Standard-Intelligence/hertz-dev,https://github.com/Standard-Intelligence/hertz-dev,1707,first base model for full-duplex conversational audio,Apache License 2.0,0,0,13,0,2024-11-03
jingyaogong/minimind-v,https://github.com/jingyaogong/minimind-v,1113,üöÄ „ÄåÂ§ßÊ®°Âûã„Äç3Â∞èÊó∂‰ªé0ËÆ≠ÁªÉ27MÂèÇÊï∞ÁöÑËßÜËßâÂ§öÊ®°ÊÄÅVLMÔºÅüåè Train a 27M-parameter VLM from scratch in just 3 hours!,Apache License 2.0,0,0,13,0,2024-09-11
mikekelly/AgentK,https://github.com/mikekelly/AgentK,931,An autoagentic AGI that is self-evolving and modular.,The MIT License,0,0,13,0,2024-08-04
taco-group/OpenEMMA,https://github.com/taco-group/OpenEMMA,495,"OpenEMMA, a permissively licensed open source ""reproduction"" of Waymo‚Äôs EMMA model.",Apache License 2.0,0,0,13,0,2024-10-30
yformer/EfficientTAM,https://github.com/yformer/EfficientTAM,475,Efficient Track Anything,Apache License 2.0,0,0,13,0,2024-12-02
microsoft/LLM2CLIP,https://github.com/microsoft/LLM2CLIP,469,LLM2CLIP makes SOTA pretrained CLIP model more SOTA ever.,The MIT License,0,0,13,0,2024-07-22
Lux-AI-Challenge/Lux-Design-S3,https://github.com/Lux-AI-Challenge/Lux-Design-S3,303,"Repository for the Lux AI Challenge, season 3 @NeurIPS 24. Hosted on @kaggle",Apache License 2.0,0,0,13,0,2024-08-18
Robot-VLAs/RoboVLMs,https://github.com/Robot-VLAs/RoboVLMs,272,,Apache License 2.0,0,0,13,0,2024-12-19
JoshuaC215/agent-service-toolkit,https://github.com/JoshuaC215/agent-service-toolkit,2284,"Full toolkit for running an AI agent service built with LangGraph, FastAPI and Streamlit",The MIT License,0,0,12,0,2024-08-04
Open-Source-O1/Open-O1,https://github.com/Open-Source-O1/Open-O1,1329,,Apache License 2.0,0,0,12,0,2024-10-02
ShengranHu/ADAS,https://github.com/ShengranHu/ADAS,1190,[ICLR 2025] Automated Design of Agentic Systems,Apache License 2.0,0,0,12,0,2024-07-31
EvolvingLMMs-Lab/open-r1-multimodal,https://github.com/EvolvingLMMs-Lab/open-r1-multimodal,740,A fork to add multimodal model training to open-r1,Apache License 2.0,0,0,12,0,2025-01-27
EnVision-Research/Lotus,https://github.com/EnVision-Research/Lotus,614,Official implementation of Lotus: Diffusion-based Visual Foundation Model for High-quality Dense Prediction,Apache License 2.0,0,0,12,0,2024-09-22
dhcode-cpp/X-R1,https://github.com/dhcode-cpp/X-R1,428,minimal-cost for training 0.5B R1-Zero,Apache License 2.0,0,0,12,0,2025-02-11
welltop-cn/ComfyUI-TeaCache,https://github.com/welltop-cn/ComfyUI-TeaCache,391,,Apache License 2.0,0,0,12,0,2025-01-07
replicate/flux-fine-tuner,https://github.com/replicate/flux-fine-tuner,356,Cog wrapper for ostris/ai-toolkit + post-finetuning cog inference for flux models,Apache License 2.0,0,0,12,0,2024-08-14
codematrixer/hmdriver2,https://github.com/codematrixer/hmdriver2,294,UI Automation Framework for HarmonyOS NEXT | È∏øËíôNEXTËá™Âä®ÂåñÊ°ÜÊû∂,The MIT License,0,0,12,0,2024-08-15
panel-extensions/panel-graphic-walker,https://github.com/panel-extensions/panel-graphic-walker,291,A project providing a Graphic Walker Pane for use with HoloViz Panel.,The MIT License,0,0,12,0,2024-10-25
pengHTYX/PSHuman,https://github.com/pengHTYX/PSHuman,288,,The MIT License,0,0,12,0,2024-09-16
THUDM/CogView3,https://github.com/THUDM/CogView3,283,text to image to  generation: CogView3-Plus and CogView3(ECCV 2024),Apache License 2.0,0,0,12,0,2024-09-23
slashml/amd_inference,https://github.com/slashml/amd_inference,228,,Apache License 2.0,0,0,12,0,2024-10-02
hkchengrex/MMAudio,https://github.com/hkchengrex/MMAudio,1095,[arXiv 2024] Taming Multimodal Joint Training for High-Quality Video-to-Audio Synthesis,The MIT License,0,0,11,0,2024-12-07
DepthAnything/PromptDA,https://github.com/DepthAnything/PromptDA,546,Prompt Depth Anything,Apache License 2.0,0,0,11,0,2024-12-17
bytedance/X-Portrait,https://github.com/bytedance/X-Portrait,472,"Source code for the SIGGRAPH 2024 paper ""X-Portrait: Expressive Portrait Animation with Hierarchical Motion Attention""",Apache License 2.0,0,0,11,0,2024-07-18
PrimeIntellect-ai/OpenDiloco,https://github.com/PrimeIntellect-ai/OpenDiloco,443,OpenDiLoCo: An Open-Source Framework for Globally Distributed Low-Communication Training,Apache License 2.0,0,0,11,0,2024-07-10
brainqub3/jar3d_meta_expert,https://github.com/brainqub3/jar3d_meta_expert,391,"Versatile agents for long running, research intensive tasks.",The MIT License,0,0,11,0,2024-07-08
wangjiangshan0725/RF-Solver-Edit,https://github.com/wangjiangshan0725/RF-Solver-Edit,381,Taming FLUX for Image Inversion & Editing; OpenSora for Video Inversion & Editing! (Official implementation for Taming Rectified Flow for Inversion and Editing.),Apache License 2.0,0,0,11,0,2024-11-05
SuperMedIntel/Medical-Graph-RAG,https://github.com/SuperMedIntel/Medical-Graph-RAG,354,Medical Graph RAG: Graph RAG for the Medical Data,The MIT License,0,0,11,0,2024-08-08
glomatico/votify,https://github.com/glomatico/votify,325,A Python CLI app for downloading songs/podcasts from Spotify.,The MIT License,0,0,11,0,2024-09-20
joonspk-research/genagents,https://github.com/joonspk-research/genagents,315,,The MIT License,0,0,11,0,2024-11-15
AeroScripts/leapfusion-hunyuan-image2video,https://github.com/AeroScripts/leapfusion-hunyuan-image2video,267,A novel approach to hunyuan image-to-video sampling,Apache License 2.0,0,0,11,0,2025-01-22
heurist-network/heurist-agent-framework,https://github.com/heurist-network/heurist-agent-framework,231,,The MIT License,0,0,11,0,2024-12-02
facebookresearch/large_concept_model,https://github.com/facebookresearch/large_concept_model,1928,Large Concept Models: Language modeling in a sentence representation space,The MIT License,0,0,10,0,2024-12-12
character-ai/prompt-poet,https://github.com/character-ai/prompt-poet,1028,Streamlines and simplifies prompt design for both developers and non-technical users with a low code approach.,The MIT License,0,0,10,0,2024-07-17
TTPlanetPig/Comfyui_Object_Migration,https://github.com/TTPlanetPig/Comfyui_Object_Migration,646,This is a study aim to transfer the single concept by using DIT model self-attention capablity,The MIT License,0,0,10,0,2024-11-15
huanngzh/MV-Adapter,https://github.com/huanngzh/MV-Adapter,569,"[768 Resolution] [Any ""SDXL"" Model] [Various Conditions] [Arbitrary Views] Official impl. of ""MV-Adapter: Multi-view Consistent Image Generation Made Easy""",Apache License 2.0,0,0,10,0,2024-11-27
1andrevich/Re-filter-lists,https://github.com/1andrevich/Re-filter-lists,564,Re:filter is (an attempt to create) an actual list of blocked domains and IPs in RU + popular and blocked for RU users ,The MIT License,0,0,10,0,2024-09-28
NJU-PCALab/RAG-Diffusion,https://github.com/NJU-PCALab/RAG-Diffusion,541,Region-Aware Text-to-Image Generation via Hard Binding and Soft Refinement üî•,The MIT License,0,0,10,0,2024-11-08
cvg/GeoCalib,https://github.com/cvg/GeoCalib,537,GeoCalib: Learning Single-image Calibration with Geometric Optimization (ECCV 2024),Apache License 2.0,0,0,10,0,2024-09-05
arcee-ai/DistillKit,https://github.com/arcee-ai/DistillKit,497,An Open Source Toolkit For LLM Distillation,Apache License 2.0,0,0,10,0,2024-07-31
lamm-mit/SciAgentsDiscovery,https://github.com/lamm-mit/SciAgentsDiscovery,471,,Apache License 2.0,0,0,10,0,2024-08-21
microsoft/rStar,https://github.com/microsoft/rStar,428,,The MIT License,0,0,10,0,2024-08-27
Kiri-Innovation/3dgs-render-blender-addon,https://github.com/Kiri-Innovation/3dgs-render-blender-addon,423,3DGS Render by KIRI Engine,Apache License 2.0,0,0,10,0,2024-09-27
revdotcom/reverb,https://github.com/revdotcom/reverb,377,Open source inference code for Rev's model,Apache License 2.0,0,0,10,0,2024-09-16
PJLab-ADG/DriveArena,https://github.com/PJLab-ADG/DriveArena,297,DriveArena: A Closed-loop Generative Simulation Platform for Autonomous Driving,Apache License 2.0,0,0,10,0,2024-07-30
autonomousvision/LaRa,https://github.com/autonomousvision/LaRa,297,"[ECCV 2024] Efficient Large-Baseline Radiance Fields,  a feed-forward 2DGS model",The MIT License,0,0,10,0,2024-07-08
lixiaowen-xw/DiffuEraser,https://github.com/lixiaowen-xw/DiffuEraser,293,,Apache License 2.0,0,0,10,0,2025-01-17
leettools-dev/leettools,https://github.com/leettools-dev/leettools,252,AI Search tools.,Apache License 2.0,0,0,10,0,2024-12-19
zorazrw/agent-workflow-memory,https://github.com/zorazrw/agent-workflow-memory,241,AWM: Agent Workflow Memory,Apache License 2.0,0,0,10,0,2024-08-28
isarandi/nlf,https://github.com/isarandi/nlf,240,[NeurIPS 2024] Neural Localizer Fields for Continuous 3D Human Pose and Shape Estimation,The MIT License,0,0,10,0,2024-08-25
Physical-Intelligence/openpi,https://github.com/Physical-Intelligence/openpi,2187,,Apache License 2.0,0,0,9,0,2024-10-21
Om-Alve/smolGPT,https://github.com/Om-Alve/smolGPT,1278,,The MIT License,0,0,9,0,2025-01-12
microsoft/mattergen,https://github.com/microsoft/mattergen,1150,Official implementation of MatterGen -- a generative model for inorganic materials design across the periodic table that can be fine-tuned to steer the generation towards a wide range of property constraints.,The MIT License,0,0,9,0,2024-11-27
Henry-23/VideoChat,https://github.com/Henry-23/VideoChat,690,"ÂÆûÊó∂ËØ≠Èü≥‰∫§‰∫íÊï∞Â≠ó‰∫∫ÔºåÊîØÊåÅÁ´ØÂà∞Á´ØËØ≠Èü≥ÊñπÊ°àÔºàGLM-4-Voice - THGÔºâÂíåÁ∫ßËÅîÊñπÊ°àÔºàASR-LLM-TTS-THGÔºâ„ÄÇÂèØËá™ÂÆö‰πâÂΩ¢Ë±°‰∏éÈü≥Ëâ≤ÔºåÊó†È°ªËÆ≠ÁªÉÔºåÊîØÊåÅÈü≥Ëâ≤ÂÖãÈöÜÔºåÈ¶ñÂåÖÂª∂Ëøü‰ΩéËá≥3s„ÄÇReal-time voice interactive digital human, supporting end-to-end voice solutions (GLM-4-Voice - THG) and cascaded solutions (ASR-LLM-TTS-THG). Customizable appearance and voice, supporting voice cloning, with initial package delay as low as 3s.",The MIT License,0,0,9,0,2024-10-18
Adamdad/kat,https://github.com/Adamdad/kat,683,[ICLR2025] Kolmogorov-Arnold Transformer,The MIT License,0,0,9,0,2024-09-05
kuangdd2024/auto-video-generateor,https://github.com/kuangdd2024/auto-video-generateor,621,Ëá™Âä®ËßÜÈ¢ëÁîüÊàêÂô®ÔºåÁªôÂÆö‰∏ªÈ¢òÔºåËá™Âä®ÁîüÊàêËß£ËØ¥ËßÜÈ¢ë„ÄÇÁî®Êà∑ËæìÂÖ•‰∏ªÈ¢òÊñáÂ≠óÔºåÁ≥ªÁªüË∞ÉÁî®Â§ßËØ≠Ë®ÄÊ®°ÂûãÁîüÊàêÊïÖ‰∫ãÊàñËß£ËØ¥ÁöÑÊñáÂ≠óÔºåÁÑ∂ÂêéËøõ‰∏ÄÊ≠•Ë∞ÉÁî®ËØ≠Èü≥ÂêàÊàêÊé•Âè£ÁîüÊàêËß£ËØ¥ÁöÑËØ≠Èü≥ÔºåË∞ÉÁî®ÊñáÁîüÂõæÊé•Âè£ÁîüÊàêÂ•ëÂêàÊñáÂ≠óÂÜÖÂÆπÁöÑÈÖçÂõæÔºåÊúÄÂêéËûçÂêàËØ≠Èü≥ÂíåÈÖçÂõæÁîüÊàêËß£ËØ¥ËßÜÈ¢ë„ÄÇ,The MIT License,0,0,9,0,2024-08-12
whyhow-ai/knowledge-graph-studio,https://github.com/whyhow-ai/knowledge-graph-studio,594,WhyHow Knowledge Graph Studio,The MIT License,0,0,9,0,2024-11-18
basnijholt/tuitorial,https://github.com/basnijholt/tuitorial,478,Create beautiful terminal-based code tutorials with syntax highlighting and interactive navigation.,The MIT License,0,0,9,0,2024-12-24
THUDM/LongCite,https://github.com/THUDM/LongCite,465,LongCite: Enabling LLMs to Generate Fine-grained Citations in Long-context QA,Apache License 2.0,0,0,9,0,2024-08-31
jdh-algo/JoyHallo,https://github.com/jdh-algo/JoyHallo,439,JoyHallo: Digital human model for Mandarin,The MIT License,0,0,9,0,2024-09-14
mit-han-lab/duo-attention,https://github.com/mit-han-lab/duo-attention,427,[ICLR 2025] DuoAttention: Efficient Long-Context LLM Inference with Retrieval and Streaming Heads,The MIT License,0,0,9,0,2024-10-15
2U1/Qwen2-VL-Finetune,https://github.com/2U1/Qwen2-VL-Finetune,292,An open-source implementaion for fine-tuning Qwen2-VL and Qwen2.5-VL series by Alibaba Cloud.,Apache License 2.0,0,0,9,0,2024-09-10
allenai/molmo,https://github.com/allenai/molmo,287,Code for the Molmo Vision-Language Model,Apache License 2.0,0,0,9,0,2024-12-05
dvlab-research/VisionZip,https://github.com/dvlab-research/VisionZip,237,"Official repo for ""VisionZip: Longer is Better but Not Necessary in Vision Language Models""",Apache License 2.0,0,0,9,0,2024-12-02
TheBlewish/Automated-AI-Web-Researcher-Ollama,https://github.com/TheBlewish/Automated-AI-Web-Researcher-Ollama,2680,"A python program that turns an LLM, running on Ollama, into an automated researcher, which will with a single query determine focus areas to investigate, do websearches and scrape content from various relevant websites and do research for you all on its own! And more, not limited to but including saving the findings for you!",The MIT License,0,0,8,0,2024-11-20
OpenCoder-llm/OpenCoder-llm,https://github.com/OpenCoder-llm/OpenCoder-llm,1614,The Open Cookbook for Top-Tier Code Large Language Model,The MIT License,0,0,8,0,2024-10-26
lfnovo/open-notebook,https://github.com/lfnovo/open-notebook,1022,An Open Source implementation of Notebook LM with more flexibility and features,The MIT License,0,0,8,0,2024-10-21
OpenBMB/IoA,https://github.com/OpenBMB/IoA,659,"An open-source framework for collaborative AI agents, enabling diverse, distributed agents to team up and tackle complex tasks through internet-like connectivity.",Apache License 2.0,0,0,8,0,2024-07-08
dbos-inc/dbos-transact-py,https://github.com/dbos-inc/dbos-transact-py,563,Ultra-Lightweight Durable Execution in Python,The MIT License,0,0,8,0,2024-07-19
Haiyang-W/TokenFormer,https://github.com/Haiyang-W/TokenFormer,514,[ICLR2025 Spotlightüî•] Official Implementation of TokenFormer: Rethinking Transformer Scaling with Tokenized Model Parameters,Apache License 2.0,0,0,8,0,2024-10-29
openai/SWELancer-Benchmark,https://github.com/openai/SWELancer-Benchmark,477,"This repo contains the dataset and code for the paper ""SWE-Lancer: Can Frontier LLMs Earn $1 Million from Real-World Freelance Software Engineering?""",The MIT License,0,0,8,0,2025-02-18
browser-use/macOS-use,https://github.com/browser-use/macOS-use,467,Make Mac apps accessible for AI agents,The MIT License,0,0,8,0,2025-01-23
huggingface/meshgen,https://github.com/huggingface/meshgen,466,A blender addon for generating meshes with AI,The MIT License,0,0,8,0,2024-10-14
ryanontheinside/ComfyUI_RyanOnTheInside,https://github.com/ryanontheinside/ComfyUI_RyanOnTheInside,418,"Everything-Reactivity in ComfyUI (audio, MIDI, motion, proximity, and more).",The MIT License,0,0,8,0,2024-08-15
kvfrans/shortcut-models,https://github.com/kvfrans/shortcut-models,372,,The MIT License,0,0,8,0,2024-10-01
FunAudioLLM/FunAudioLLM-APP,https://github.com/FunAudioLLM/FunAudioLLM-APP,327,,The MIT License,0,0,8,0,2024-07-03
cnunescoelho/kiroku,https://github.com/cnunescoelho/kiroku,322,Multi-agent that helps you organize and write documents.,Apache License 2.0,0,0,8,0,2024-09-21
coleam00/Archon,https://github.com/coleam00/Archon,300,Archon is an AI agent that is able to create other AI agents using an advanced agentic coding workflow and framework knowledge base to unlock a new frontier of automated agents.,The MIT License,0,0,8,0,2025-02-07
Polymarket/agents,https://github.com/Polymarket/agents,277,Trade autonomously on Polymarket using AI Agents,The MIT License,0,0,8,0,2024-07-03
ByteFlow-AI/TokenFlow,https://github.com/ByteFlow-AI/TokenFlow,253,"üî• Official impl. of ""TokenFlow: Unified Image Tokenizer for Multimodal Understanding and Generation"".",Apache License 2.0,0,0,8,0,2024-12-03
DeDolphins/DataHorse,https://github.com/DeDolphins/DataHorse,251,"Chat with your data, modify it, visualize it, create and test machine learning models all in plain English. DataHorse makes data analysis and data science conversational using LLMs.",The MIT License,0,0,8,0,2024-08-15
niceberginc/agentipy,https://github.com/niceberginc/agentipy,235,The #Python framework for connecting AI agents to any onchain app on  @solana-labs  ü§ñüêç,The MIT License,0,0,8,0,2024-12-15
langchain-ai/agent-protocol,https://github.com/langchain-ai/agent-protocol,232,,The MIT License,0,0,8,0,2024-11-12
yangchris11/samurai,https://github.com/yangchris11/samurai,6508,"Official repository of ""SAMURAI: Adapting Segment Anything Model for Zero-Shot Visual Tracking with Motion-Aware Memory""",Apache License 2.0,0,0,7,0,2024-11-06
langchain-ai/executive-ai-assistant,https://github.com/langchain-ai/executive-ai-assistant,1581,,The MIT License,0,0,7,0,2025-01-14
starpig1129/DATAGEN,https://github.com/starpig1129/DATAGEN,1177,"DATAGEN: AI-driven multi-agent research assistant automating hypothesis generation, data analysis, and report writing. Now expanding into crypto market intelligence. Learn more: https://datagen.digital/.",The MIT License,0,0,7,0,2024-07-23
hhhuang/CAG,https://github.com/hhhuang/CAG,1015,"Cache-Augmented Generation: A Simple, Efficient Alternative to RAG",The MIT License,0,0,7,0,2024-12-11
huggingface/search-and-learn,https://github.com/huggingface/search-and-learn,1000,Recipes to scale inference-time compute of open models,Apache License 2.0,0,0,7,0,2024-12-09
imanoop7/Ollama-OCR,https://github.com/imanoop7/Ollama-OCR,983,,The MIT License,0,0,7,0,2024-11-28
yoheinakajima/ditto,https://github.com/yoheinakajima/ditto,954,the simplest self-building coding agent,The MIT License,0,0,7,0,2024-10-15
SakanaAI/self-adaptive-llms,https://github.com/SakanaAI/self-adaptive-llms,946,A Self-adaptation Frameworküêô that adapts LLMs for unseen tasks in real-time!,Apache License 2.0,0,0,7,0,2024-12-02
edwko/OuteTTS,https://github.com/edwko/OuteTTS,924,Interface for OuteTTS models.,Apache License 2.0,0,0,7,0,2024-11-04
lifeiteng/OmniSenseVoice,https://github.com/lifeiteng/OmniSenseVoice,799,Omni SenseVoice: High-Speed Speech Recognition with words timestamps üó£Ô∏èüéØ,Apache License 2.0,0,0,7,0,2024-09-22
e2b-dev/open-computer-use,https://github.com/e2b-dev/open-computer-use,737,Secure AI computer use powered by E2B Desktop Sandbox,Apache License 2.0,0,0,7,0,2024-10-31
LYiHub/platform-war-public,https://github.com/LYiHub/platform-war-public,722,A chatbot/GraphRAG framework that creates multi-llm-agents from social platform user comments and let them debate on specific topics.,Apache License 2.0,0,0,7,0,2024-12-14
KwaiVGI/SynCamMaster,https://github.com/KwaiVGI/SynCamMaster,490,[ICLR'25] SynCamMaster: Synchronizing Multi-Camera Video Generation from Diverse Viewpoints,Apache License 2.0,0,0,7,0,2024-12-06
instantX-research/InstantIR,https://github.com/instantX-research/InstantIR,485,InstantIR: Blind Image Restoration with Instant Generative Reference üî•,Apache License 2.0,0,0,7,0,2024-10-20
ant-research/DepthLab,https://github.com/ant-research/DepthLab,445,"Official implementation of ""DepthLab: From Partial to Complete""",Apache License 2.0,0,0,7,0,2024-12-19
win4r/GraphRAG4OpenWebUI,https://github.com/win4r/GraphRAG4OpenWebUI,443,"GraphRAG4OpenWebUI integrates Microsoft's GraphRAG technology into Open WebUI, providing a versatile information retrieval API. It combines local, global, and web searches for advanced Q&A systems and search engines. This tool simplifies graph-based retrieval integration in open web environments.",Apache License 2.0,0,0,7,0,2024-07-15
google-deepmind/treescope,https://github.com/google-deepmind/treescope,390,An interactive HTML pretty-printer for machine learning research in IPython notebooks.,Apache License 2.0,0,0,7,0,2024-07-24
HKUDS/AutoAgent,https://github.com/HKUDS/AutoAgent,310,"""AutoAgent: Fully-Automated and Zero-Code LLM Agent Framework""",The MIT License,0,0,7,0,2025-02-06
ZiyuGuo99/SAM2Point,https://github.com/ZiyuGuo99/SAM2Point,297,The Most Faithful Implementation of Segment Anything (SAM) in 3D,Apache License 2.0,0,0,7,0,2024-08-25
mingsky-ai/ComfyUI-MingNodes,https://github.com/mingsky-ai/ComfyUI-MingNodes,267,some practical comfyui nodes,Apache License 2.0,0,0,7,0,2024-09-20
sony/genwarp,https://github.com/sony/genwarp,256,,The MIT License,0,0,7,0,2024-08-06
abhishekkrthakur/aiaio,https://github.com/abhishekkrthakur/aiaio,250,"lightweight, python based chat ui",Apache License 2.0,0,0,7,0,2025-02-08
EtiennePerot/safe-code-execution,https://github.com/EtiennePerot/safe-code-execution,249,Code execution utilities for Open WebUI & Ollama,Apache License 2.0,0,0,7,0,2024-09-03
sentient-agi/oml-1.0-fingerprinting,https://github.com/sentient-agi/oml-1.0-fingerprinting,2129,"OML 1.0 via Fingerprinting: Open, Monetizable, and Loyal AI",Apache License 2.0,0,0,6,0,2024-11-14
open-thoughts/open-thoughts,https://github.com/open-thoughts/open-thoughts,1211,Open Thoughts: Fully Open Data Curation for Thinking Models,Apache License 2.0,0,0,6,0,2025-01-27
MODSetter/SurfSense,https://github.com/MODSetter/SurfSense,1065,A Personal NotebookLM and Perplexity-like AI Assistant for Everyone. Research and Never forget Anything.,Apache License 2.0,0,0,6,0,2024-07-30
shallowdream204/DreamClear,https://github.com/shallowdream204/DreamClear,896,[NeurIPS 2024üî•] DreamClear: High-Capacity Real-World Image Restoration with Privacy-Safe Dataset Curation,Apache License 2.0,0,0,6,0,2024-10-24
ZihanWang314/RAGEN,https://github.com/ZihanWang314/RAGEN,867,RAGEN is the first open-source reproduction of DeepSeek-R1 on AGENT training.,Apache License 2.0,0,0,6,0,2025-01-25
FunAudioLLM/InspireMusic,https://github.com/FunAudioLLM/InspireMusic,816,"InspireMusic: A Unified Framework for Music, Song, Audio Generation.",Apache License 2.0,0,0,6,0,2024-10-29
superagent-ai/reag,https://github.com/superagent-ai/reag,721,Reasoning Augmented Generation,The MIT License,0,0,6,0,2025-02-02
TianxingChen/RoboTwin,https://github.com/TianxingChen/RoboTwin,598,RoboTwin: Dual-Arm Robot Benchmark with Generative Digital Twins,The MIT License,0,0,6,0,2024-09-18
plexe-ai/smolmodels,https://github.com/plexe-ai/smolmodels,530,‚ú® build ml models in natural language and minimal code,Apache License 2.0,0,0,6,0,2025-01-05
deepseek-ai/ESFT,https://github.com/deepseek-ai/ESFT,529,Expert Specialized Fine-Tuning,The MIT License,0,0,6,0,2024-07-04
LeCAR-Lab/dial-mpc,https://github.com/LeCAR-Lab/dial-mpc,514,"Official implementation for the paper ""Full-Order Sampling-Based MPC for Torque-Level Locomotion Control via Diffusion-Style Annealing"". DIAL-MPC is a novel sampling-based MPC framework for legged robot full-order torque-level control with both precision and agility in a training-free manner.",Apache License 2.0,0,0,6,0,2024-09-15
IGL-HKUST/DiffusionAsShader,https://github.com/IGL-HKUST/DiffusionAsShader,470,[arXiv 2025] Diffusion as Shader: 3D-aware Video Diffusion for Versatile Video Generation Control,Apache License 2.0,0,0,6,0,2025-01-07
jhj0517/AdvancedLivePortrait-WebUI,https://github.com/jhj0517/AdvancedLivePortrait-WebUI,449,gradio WebUI for AdvancedLivePortrait,Apache License 2.0,0,0,6,0,2024-11-05
shobrook/termite,https://github.com/shobrook/termite,350,Generative UI in your terminal,Apache License 2.0,0,0,6,0,2024-07-09
irom-princeton/dppo,https://github.com/irom-princeton/dppo,333,"Official implementation of Diffusion Policy Policy Optimization, arxiv 2024",The MIT License,0,0,6,0,2024-09-04
metauto-ai/agent-as-a-judge,https://github.com/metauto-ai/agent-as-a-judge,322,ü§† Agent-as-a-Judge and DevAI dataset,The MIT License,0,0,6,0,2024-10-16
Turing-Project/Black-Myth-Wukong-AI,https://github.com/Turing-Project/Black-Myth-Wukong-AI,299,AI demo for playing ARPG/Soul-like game with RL frame,Apache License 2.0,0,0,6,0,2024-07-12
Huage001/LinFusion,https://github.com/Huage001/LinFusion,289,"Official PyTorch and Diffusers Implementation of ""LinFusion: 1 GPU, 1 Minute, 16K Image""",Apache License 2.0,0,0,6,0,2024-09-02
convexsplatting/convex-splatting,https://github.com/convexsplatting/convex-splatting,277,"Original implementation of ""3D Convex Splatting: Radiance Field Rendering with 3D Smooth Convexes""",Apache License 2.0,0,0,6,0,2024-11-25
lucidrains/rectified-flow-pytorch,https://github.com/lucidrains/rectified-flow-pytorch,246,Implementation of rectified flow and some of its followup research / improvements in Pytorch,The MIT License,0,0,6,0,2024-07-17
mbzuai-oryx/LlamaV-o1,https://github.com/mbzuai-oryx/LlamaV-o1,246,Rethinking Step-by-step Visual  Reasoning in LLMs,Apache License 2.0,0,0,6,0,2025-01-08
GANWANSHUI/GaussianOcc,https://github.com/GANWANSHUI/GaussianOcc,245,GaussianOcc: Fully Self-supervised and Efficient 3D Occupancy Estimation with Gaussian Splatting,Apache License 2.0,0,0,6,0,2024-08-21
Unakar/Logic-RL,https://github.com/Unakar/Logic-RL,1584,Reproduce R1 Zero on Logic Puzzle,Apache License 2.0,0,0,5,0,2025-02-02
echohive42/AI-reads-books-page-by-page,https://github.com/echohive42/AI-reads-books-page-by-page,1353,"AI reads books: Page-by-Page PDF Knowledge Extractor & Summarizer. script performs an intelligent page-by-page analysis of PDF books, methodically extracting knowledge points and generating progressive summaries at specified intervals",The MIT License,0,0,5,0,2024-12-28
SonyResearch/micro_diffusion,https://github.com/SonyResearch/micro_diffusion,1246,Official repository for our work on micro-budget training of large-scale diffusion models.,Apache License 2.0,0,0,5,0,2024-07-16
lucidrains/transfusion-pytorch,https://github.com/lucidrains/transfusion-pytorch,947,"Pytorch implementation of Transfusion, ""Predict the Next Token and Diffuse Images with One Multi-Modal Model"", from MetaAI",The MIT License,0,0,5,0,2024-08-23
24mlight/A_Share_investment_Agent,https://github.com/24mlight/A_Share_investment_Agent,911,,The MIT License,0,0,5,0,2025-01-07
Vchitect/Vchitect-2.0,https://github.com/Vchitect/Vchitect-2.0,885,Vchitect-2.0: Parallel Transformer for Scaling Up Video Diffusion Models,Apache License 2.0,0,0,5,0,2024-09-09
sihyun-yu/REPA,https://github.com/sihyun-yu/REPA,832,Official Pytorch Implementation of Representation Alignment for Generation: Training Diffusion Transformers Is Easier Than You Think (ICLR 2025),The MIT License,0,0,5,0,2024-10-07
coleam00/ottomator-agents,https://github.com/coleam00/ottomator-agents,815,All the open source AI Agents hosted on the oTTomator Live Agent Studio platform!,The MIT License,0,0,5,0,2024-12-02
zilliztech/deep-searcher,https://github.com/zilliztech/deep-searcher,785,Deep Research Alternative to Reason on Private Data in Python,Apache License 2.0,0,0,5,0,2025-02-08
LeCAR-Lab/ASAP,https://github.com/LeCAR-Lab/ASAP,629,"Official implementation of ""ASAP: Aligning Simulation and Real-World Physics for Learning Agile Humanoid Whole-Body Skills""",The MIT License,0,0,5,0,2025-01-28
AkariAsai/OpenScholar,https://github.com/AkariAsai/OpenScholar,623,This repository includes the official implementation of OpenScholar: Synthesizing Scientific Literature with Retrieval-augmented LMs. ,Apache License 2.0,0,0,5,0,2024-11-15
hinthornw/promptimizer,https://github.com/hinthornw/promptimizer,619,Prompt optimization scratch,The MIT License,0,0,5,0,2024-10-30
danilofalcao/jarvis,https://github.com/danilofalcao/jarvis,555,"J.A.R.V.I.S. is an intelligent coding assistant that leverages multiple state-of-the-art language models to help you with code generation, modifications, and technical discussions.",The MIT License,0,0,5,0,2025-01-03
pippinlovesyou/pippin,https://github.com/pippinlovesyou/pippin,501,The Digital Being Framework for Autonomous Agents,The MIT License,0,0,5,0,2025-01-09
microsoft/AIOpsLab,https://github.com/microsoft/AIOpsLab,487,"A holistic framework to enable the design, development, and evaluation of autonomous AIOps agents.",The MIT License,0,0,5,0,2024-10-11
prs-eth/RollingDepth,https://github.com/prs-eth/RollingDepth,446,Video Depth without Video Models,Apache License 2.0,0,0,5,0,2024-11-25
google-deepmind/synthid-text,https://github.com/google-deepmind/synthid-text,438,,Apache License 2.0,0,0,5,0,2024-10-23
WHU-USI3DV/VistaDream,https://github.com/WHU-USI3DV/VistaDream,401,[arXiv'24] [Image-to-Scene on a 4090(24G)] VistaDream: Sampling multiview consistent images for single-view scene reconstruction,The MIT License,0,0,5,0,2024-10-21
NUS-HPC-AI-Lab/Enhance-A-Video,https://github.com/NUS-HPC-AI-Lab/Enhance-A-Video,396,Enhance-A-Video: Better Generated Video for Free,Apache License 2.0,0,0,5,0,2024-12-18
modelscope/MemoryScope,https://github.com/modelscope/MemoryScope,393,,Apache License 2.0,0,0,5,0,2024-08-29
ali-vilab/TeaCache,https://github.com/ali-vilab/TeaCache,362,Timestep Embedding Tells: It's Time to Cache for Video Diffusion Model,Apache License 2.0,0,0,5,0,2024-11-27
Quarm-AI/Quarm,https://github.com/Quarm-AI/Quarm,351,An AI agent swarm framework built in Python,The MIT License,0,0,5,0,2025-01-16
microsoft/VidTok,https://github.com/microsoft/VidTok,337,a family of versatile and state-of-the-art video tokenizers.,The MIT License,0,0,5,0,2024-12-06
TheBlewish/Web-LLM-Assistant-Llamacpp-Ollama,https://github.com/TheBlewish/Web-LLM-Assistant-Llamacpp-Ollama,337,A Python-based web-assisted large language model (LLM) search assistant using Llama.cpp,The MIT License,0,0,5,0,2024-09-10
langchain-ai/langgraph-supervisor,https://github.com/langchain-ai/langgraph-supervisor,331,,The MIT License,0,0,5,0,2025-02-05
epuerta9/deep-research-py,https://github.com/epuerta9/deep-research-py,322,save 200 a month and use deep research right in your terminal. - port of https://github.com/dzhng/deep-research but in python,The MIT License,0,0,5,0,2025-02-07
hmrishavbandy/FlipSketch,https://github.com/hmrishavbandy/FlipSketch,320,FlipSketch: Flipping Static Drawings to Text-Guided Sketch Animations,The MIT License,0,0,5,0,2024-11-15
thunlp/ProactiveAgent,https://github.com/thunlp/ProactiveAgent,300,A LLM-based Agent that predict its tasks proactively.,Apache License 2.0,0,0,5,0,2024-09-19
drmingler/docling-api,https://github.com/drmingler/docling-api,299,"Easily deployable and scalable backend server that efficiently converts various document formats (pdf, docx, pptx, html, images, etc) into Markdown. With support for both CPU and GPU processing, it is Ideal for large-scale workflows, it offers text/table extraction, OCR, and batch processing with sync/async endpoints.",The MIT License,0,0,5,0,2024-11-05
thuhcsi/MagicMan,https://github.com/thuhcsi/MagicMan,288,"Official repository for paper ""MagicMan: Generative Novel View Synthesis of Humans with 3D-Aware Diffusion and Iterative Refinement""",The MIT License,0,0,5,0,2024-08-25
sam-paech/antislop-sampler,https://github.com/sam-paech/antislop-sampler,268,,Apache License 2.0,0,0,5,0,2024-09-27
askui/vision-agent,https://github.com/askui/vision-agent,251,Automate computer tasks in Python,The MIT License,0,0,5,0,2024-10-25
PRIME-RL/PRIME,https://github.com/PRIME-RL/PRIME,1260,Scalable RL solution for advanced reasoning of language models,Apache License 2.0,0,0,4,0,2024-12-31
microsoft/MarS,https://github.com/microsoft/MarS,1255,MarS: a Financial Market Simulation Engine Powered by Generative Foundation Model,The MIT License,0,0,4,0,2024-10-28
BMPixel/moffee,https://github.com/BMPixel/moffee,1048,moffee: Make Markdown Ready to Present,The MIT License,0,0,4,0,2024-08-05
lmnr-ai/flow,https://github.com/lmnr-ai/flow,886,A lightweight task engine for building stateful AI agents that prioritizes simplicity and flexibility.,Apache License 2.0,0,0,4,0,2024-11-30
bytedance/pasa,https://github.com/bytedance/pasa,842,"PaSa -- an advanced paper search agent powered by large language models. It can autonomously make a series of decisions, including invoking search tools, reading papers, and selecting relevant references, to ultimately obtain comprehensive and accurate results for complex scholarly queries.",Apache License 2.0,0,0,4,0,2024-12-23
aiola-lab/whisper-medusa,https://github.com/aiola-lab/whisper-medusa,821,Whisper with Medusa heads,The MIT License,0,0,4,0,2024-07-17
hrithikkoduri/WebRover,https://github.com/hrithikkoduri/WebRover,750,"WebRover is an autonomous AI agent designed to interpret user input and execute actions by interacting with web elements to accomplish tasks or answer questions. It leverages advanced language models and web automation tools to navigate the web, gather information, and provide structured responses based on the user's needs.",The MIT License,0,0,4,0,2025-01-14
dynamiq-ai/dynamiq,https://github.com/dynamiq-ai/dynamiq,736,Dynamiq is an orchestration framework for agentic AI and LLM applications,Apache License 2.0,0,0,4,0,2024-09-26
icip-cas/PPTAgent,https://github.com/icip-cas/PPTAgent,599,PPTAgent: Generating and Evaluating Presentations Beyond Text-to-Slides,The MIT License,0,0,4,0,2025-01-04
Doriandarko/RAT-retrieval-augmented-thinking,https://github.com/Doriandarko/RAT-retrieval-augmented-thinking,583,RAT is a powerful tool that improves AI responses by leveraging DeepSeek's reasoning capabilities to guide other models through a structured thinking process.,The MIT License,0,0,4,0,2025-01-23
fkryan/gazelle,https://github.com/fkryan/gazelle,493,Gaze-LLE: Gaze Target Estimation via Large-Scale Learned Encoders,The MIT License,0,0,4,0,2024-12-09
ant-research/AniDoc,https://github.com/ant-research/AniDoc,475,Official Implementations for Paper - AniDoc: Animation Creation Made Easier,Apache License 2.0,0,0,4,0,2024-12-18
fallenshock/FlowEdit,https://github.com/fallenshock/FlowEdit,448,"Official implementation of the paper: ""FlowEdit: Inversion-Free Text-Based Editing Using Pre-Trained Flow Models""",The MIT License,0,0,4,0,2024-11-22
lucidrains/e2-tts-pytorch,https://github.com/lucidrains/e2-tts-pytorch,437,"Implementation of E2-TTS, ""Embarrassingly Easy Fully Non-Autoregressive Zero-Shot TTS"", in Pytorch",The MIT License,0,0,4,0,2024-07-09
mega-sam/mega-sam,https://github.com/mega-sam/mega-sam,433,"Code for the project ""MegaSaM: Accurate, Fast and Robust Structure and Motion from Casual Dynamic Videos""",Apache License 2.0,0,0,4,0,2024-12-06
DAMO-NLP-SG/CoI-Agent,https://github.com/DAMO-NLP-SG/CoI-Agent,428,Official code for paper: Chain of Ideas: Revolutionizing Research via Novel Idea Development with LLM Agents,Apache License 2.0,0,0,4,0,2024-10-10
deepseek-ai/DeepSeek-Prover-V1.5,https://github.com/deepseek-ai/DeepSeek-Prover-V1.5,422,,The MIT License,0,0,4,0,2024-08-15
Xiaojiu-z/Stable-Hair,https://github.com/Xiaojiu-z/Stable-Hair,417,Stable-Hair: Real-World Hair Transfer via Diffusion Model (AAAI 2025),Apache License 2.0,0,0,4,0,2024-07-16
sentient-engineering/agent-q,https://github.com/sentient-engineering/agent-q,396,agent q - oss advanced reasoning and learning for autonomous ai agents,The MIT License,0,0,4,0,2024-08-24
stacklok/promptwright,https://github.com/stacklok/promptwright,380,Generate large synthetic data using an LLM,Apache License 2.0,0,0,4,0,2024-10-25
bytedance/VideoWorld,https://github.com/bytedance/VideoWorld,368,VideoWorld is a simple generative model that learns purely from unlabeled videos‚Äîmuch like how babies learn by observing their environment,Apache License 2.0,0,0,4,0,2025-01-15
mouredev/logica-aplicada,https://github.com/mouredev/logica-aplicada,358,Proyectos creados por la comunidad MoureDev durante 2025 para practicar l√≥gica y aprender a implementar diferentes funcionalidades reales y habituales en todo tipo de aplicaciones.,Apache License 2.0,0,0,4,0,2025-01-31
Stability-AI/stable-codec,https://github.com/Stability-AI/stable-codec,328,A family of state-of-the-art Transformer-based audio codecs for low-bitrate high-quality audio coding.,The MIT License,0,0,4,0,2024-11-29
ADaM-BJTU/O1-CODER,https://github.com/ADaM-BJTU/O1-CODER,325,AN O1 REPLICATION FOR CODING,The MIT License,0,0,4,0,2024-11-28
kennethnym/infinifi,https://github.com/kennethnym/infinifi,293,infinifi plays gentle lofi music in the background indefinitely,Apache License 2.0,0,0,4,0,2024-07-20
Pscgylotti/RAIN,https://github.com/Pscgylotti/RAIN,291,,Apache License 2.0,0,0,4,0,2024-12-31
RightTyper/RightTyper,https://github.com/RightTyper/RightTyper,290,"A fast and efficient type assistant for Python, including tensor shape inference",Apache License 2.0,0,0,4,0,2024-07-31
ekinakyurek/marc,https://github.com/ekinakyurek/marc,290,"Public repository for ""The Surprising Effectiveness of Test-Time Training for Abstract Reasoning""",The MIT License,0,0,4,0,2024-11-10
dreadnode/dyana,https://github.com/dreadnode/dyana,288,"A sandbox environment designed for loading, running and profiling a wide range of files, including machine learning models, ELFs, Pickle, Javascript and more",The MIT License,0,0,4,0,2024-10-30
Oryx-mllm/Oryx,https://github.com/Oryx-mllm/Oryx,287,[ICLR 2025] MLLM for On-Demand Spatial-Temporal Understanding at Arbitrary Resolution,The MIT License,0,0,4,0,2024-09-19
bcmi/Light-A-Video,https://github.com/bcmi/Light-A-Video,287,Light-A-Video: Training-free Video Relighting via Progressive Light Fusion,Apache License 2.0,0,0,4,0,2025-01-16
pyloid/pyloid,https://github.com/pyloid/pyloid,277,"Pyloid is the Python backend version of Electron and Tauri, providing an open-source project that allows you to easily utilize various Python integration features. With Pyloid, developing desktop applications becomes simple, enabling you to build apps by integrating Python's powerful capabilities.",Apache License 2.0,0,0,4,0,2024-10-04
AaronZ345/TCSinger,https://github.com/AaronZ345/TCSinger,265,PyTorch Implementation of TCSinger(EMNLP 2024): Zero-Shot Singing Voice Synthesis with Style Transfer and Multi-Level Style Control,The MIT License,0,0,4,0,2024-09-20
cagostino/npcsh,https://github.com/cagostino/npcsh,260,The AI toolkit for the AI developer,The MIT License,0,0,4,0,2024-09-27
baaivision/DIVA,https://github.com/baaivision/DIVA,257,[ICLR 2025] Diffusion Feedback Helps CLIP See Better,The MIT License,0,0,4,0,2024-07-30
jeanne-wang/svd_keyframe_interpolation,https://github.com/jeanne-wang/svd_keyframe_interpolation,247,,Apache License 2.0,0,0,4,0,2024-08-26
OpenMOSS/SpeechGPT-2.0-preview,https://github.com/OpenMOSS/SpeechGPT-2.0-preview,246,"GPT-4o-level, real-time spoken dialogue system.",Apache License 2.0,0,0,4,0,2025-01-26
airweave-ai/airweave,https://github.com/airweave-ai/airweave,245,Turn any app into agent knowledge,Apache License 2.0,0,0,4,0,2024-12-24
SecretiveShell/MCP-Bridge,https://github.com/SecretiveShell/MCP-Bridge,245,A middleware to provide an openAI compatible endpoint that can call MCP tools,The MIT License,0,0,4,0,2024-11-30
Lewis-Stuart-11/3DGS-to-PC,https://github.com/Lewis-Stuart-11/3DGS-to-PC,239,3DGS-to-PC: Convert a 3D gaussian splatting scene into a dense point cloud or basic mesh with advanced customisation options and high-accuracy rendered point colours,Apache License 2.0,0,0,4,0,2024-07-11
Ola-Omni/Ola,https://github.com/Ola-Omni/Ola,228,Ola: Pushing the Frontiers of Omni-Modal Language Model,Apache License 2.0,0,0,4,0,2025-02-03
raga-ai-hub/RagaAI-Catalyst,https://github.com/raga-ai-hub/RagaAI-Catalyst,11674,"Python SDK for Agent AI Observability, Monitoring and Evaluation Framework. Includes features like agent, llm and tools tracing, debugging multi-agentic system, self-hosted dashboard and advanced analytics with timeline and execution graph view ",Apache License 2.0,0,0,3,0,2024-08-26
alibaba/Tora,https://github.com/alibaba/Tora,1070,"The official repository for paper ""Tora: Trajectory-oriented Diffusion Transformer for Video Generation""",Apache License 2.0,0,0,3,0,2024-10-14
DennisThink/awesome_twitter_CN,https://github.com/DennisThink/awesome_twitter_CN,929,ÂÄºÂæóÂÖ≥Ê≥®ÁöÑ‰∏≠ÊñátwitterÁî®Êà∑,The MIT License,0,0,3,0,2024-07-12
simular-ai/Agent-S,https://github.com/simular-ai/Agent-S,807,Agent S: an open agentic framework that uses computers like a human,Apache License 2.0,0,0,3,0,2024-10-09
zhaochenyang20/Awesome-ML-SYS-Tutorial,https://github.com/zhaochenyang20/Awesome-ML-SYS-Tutorial,793,My learning notes/codes for ML SYS.,Apache License 2.0,0,0,3,0,2024-11-09
facebookresearch/uco3d,https://github.com/facebookresearch/uco3d,792,Uncommon Objects in 3D dataset,Creative Commons Attribution 4.0 International,0,0,3,0,2024-12-03
deep-diver/paper-reviewer,https://github.com/deep-diver/paper-reviewer,732,"Generate a comprehensive review from an arXiv paper, then turn it into a blog post. This project powers the website below for the HuggingFace's Daily Papers (https://huggingface.co/papers).",Apache License 2.0,0,0,3,0,2024-10-21
theredsix/cerebellum,https://github.com/theredsix/cerebellum,730,Browser automation system that uses AI-driven planning to navigate web pages and perform goals.,The MIT License,0,0,3,0,2024-09-16
HKUDS/MiniRAG,https://github.com/HKUDS/MiniRAG,709,"""MiniRAG: Making RAG Simpler with Small and Free Language Models""",The MIT License,0,0,3,0,2025-01-11
0xfdf/toraniko,https://github.com/0xfdf/toraniko,684,A multi-factor equity risk model for quantitative trading.,The MIT License,0,0,3,0,2024-07-03
ynwarcs/CVE-2024-38063,https://github.com/ynwarcs/CVE-2024-38063,649,poc for CVE-2024-38063 (RCE in tcpip.sys),The MIT License,0,0,3,0,2024-08-24
sunnynexus/Search-o1,https://github.com/sunnynexus/Search-o1,627,Search-o1: Agentic Search-Enhanced Large Reasoning Models,The MIT License,0,0,3,0,2025-01-03
caspianmoon/memoripy,https://github.com/caspianmoon/memoripy,551,"An AI memory layer with short- and long-term storage, semantic clustering, and optional memory decay for context-aware applications.",Apache License 2.0,0,0,3,0,2024-11-07
oop7/YTSage,https://github.com/oop7/YTSage,544,"Modern YouTube downloader with a clean PySide6 interface. Download videos in any quality, extract audio, fetch subtitles, sponserBlock, and view video metadata. Built with yt-dlp for reliable performance.",The MIT License,0,0,3,0,2024-11-29
24mlight/Free_US_Investment_Agent_System,https://github.com/24mlight/Free_US_Investment_Agent_System,543,,The MIT License,0,0,3,0,2025-01-24
memodb-io/memobase,https://github.com/memodb-io/memobase,533,Profile-Based Long-Term Memory for AI Applications,Apache License 2.0,0,0,3,0,2024-09-03
Marven11/EtherGhost,https://github.com/Marven11/EtherGhost,503,Êñ∞‰∏Ä‰ª£WebshellÁÆ°ÁêÜÂô®ÔºåÂÖºÂÆπËöÅÂâë‰∏éÂÜ∞ËùéÁöÑPHP webshell,The MIT License,0,0,3,0,2024-10-08
centerforaisafety/hle,https://github.com/centerforaisafety/hle,446,Humanity's Last Exam,The MIT License,0,0,3,0,2025-01-23
amanvirparhar/chaplin,https://github.com/amanvirparhar/chaplin,432,A real-time silent speech recognition tool.,The MIT License,0,0,3,0,2025-02-03
xg-chu/GAGAvatar,https://github.com/xg-chu/GAGAvatar,418,[NeurIPS 2024] Generalizable and Animatable Gaussian Head Avatar,The MIT License,0,0,3,0,2024-09-26
WintrCat/chessencryption,https://github.com/WintrCat/chessencryption,412,Chess Encryption üîë,The MIT License,0,0,3,0,2024-09-05
OpenBMB/UltraRAG,https://github.com/OpenBMB/UltraRAG,397,Build & Optimize your RAG.,Apache License 2.0,0,0,3,0,2025-01-16
argilla-io/synthetic-data-generator,https://github.com/argilla-io/synthetic-data-generator,367,Build datasets using natural language,Apache License 2.0,0,0,3,0,2024-11-21
Maldev-Academy/ExecutePeFromPngViaLNK,https://github.com/Maldev-Academy/ExecutePeFromPngViaLNK,355,Extract and execute a PE embedded within a PNG file using an LNK file.,The MIT License,0,0,3,0,2024-10-26
opendilab/CleanS2S,https://github.com/opendilab/CleanS2S,336,High-quality and streaming Speech-to-Speech interactive agent in a single file.  Âè™Áî®‰∏Ä‰∏™Êñá‰ª∂ÂÆûÁé∞ÁöÑÊµÅÂºèÂÖ®ÂèåÂ∑•ËØ≠Èü≥‰∫§‰∫íÂéüÂûãÊô∫ËÉΩ‰ΩìÔºÅ,Apache License 2.0,0,0,3,0,2024-09-26
facebookresearch/audiobox-aesthetics,https://github.com/facebookresearch/audiobox-aesthetics,333,"Unified automatic quality assessment for speech, music, and sound.",Creative Commons Attribution 4.0 International,0,0,3,0,2025-01-22
sayakpaul/diffusers-torchao,https://github.com/sayakpaul/diffusers-torchao,319,End-to-end recipes for optimizing diffusion models with torchao and diffusers (inference and FP8 training).,Apache License 2.0,0,0,3,0,2024-08-05
infinigence/Infini-Megrez,https://github.com/infinigence/Infini-Megrez,308,,Apache License 2.0,0,0,3,0,2024-09-20
PragmaticMachineLearning/docai,https://github.com/PragmaticMachineLearning/docai,306,Structured information extraction from documents,The MIT License,0,0,3,0,2024-09-07
klara-research/klarity,https://github.com/klara-research/klarity,302,See Through Your Models,Apache License 2.0,0,0,3,0,2025-01-24
win4r/o1,https://github.com/win4r/o1,301,Using Groq or OpenAI or Ollama to create o1-like reasoning chains,The MIT License,0,0,3,0,2024-09-17
tensorgi/T6,https://github.com/tensorgi/T6,297,The official implementation of Tensor ProducT ATTenTion Transformer (T6),The MIT License,0,0,3,0,2025-01-10
orbital-materials/orb-models,https://github.com/orbital-materials/orb-models,287,ORB forcefield models from Orbital Materials,Apache License 2.0,0,0,3,0,2024-08-30
viiika/Meissonic,https://github.com/viiika/Meissonic,285,[ICLR 2025] Official Implementation of Meissonic: Revitalizing Masked Generative Transformers for Efficient High-Resolution Text-to-Image Synthesis,Apache License 2.0,0,0,3,0,2024-10-13
lucidrains/minGRU-pytorch,https://github.com/lucidrains/minGRU-pytorch,279,Implementation of the proposed minGRU in Pytorch,The MIT License,0,0,3,0,2024-10-04
dvlab-research/Lyra,https://github.com/dvlab-research/Lyra,276,Lyra: An Efficient and Speech-Centric Framework for Omni-Cognition,Apache License 2.0,0,0,3,0,2024-11-28
xingchensong/S3Tokenizer,https://github.com/xingchensong/S3Tokenizer,249,Reverse Engineering of Supervised Semantic Speech Tokenizer (S3Tokenizer) proposed in CosyVoice,Apache License 2.0,0,0,3,0,2024-09-09
zjysteven/lmms-finetune,https://github.com/zjysteven/lmms-finetune,245,"A minimal codebase for finetuning large multimodal models, supporting llava-1.5/1.6, llava-interleave, llava-next-video, llava-onevision, llama-3.2-vision, qwen-vl, qwen2-vl, phi3-v etc.",Apache License 2.0,0,0,3,0,2024-07-20
chenguolin/DiffSplat,https://github.com/chenguolin/DiffSplat,242,"[ICLR 2025] Official implementation of ""DiffSplat: Repurposing Image Diffusion Models for Scalable 3D Gaussian Splat Generation"".",The MIT License,0,0,3,0,2025-01-28
MinishLab/vicinity,https://github.com/MinishLab/vicinity,242,Lightweight Nearest Neighbors with Flexible Backends,The MIT License,0,0,3,0,2024-11-07
shobrook/promptimal,https://github.com/shobrook/promptimal,241,"A very fast, very minimal prompt optimizer",The MIT License,0,0,3,0,2024-11-11
unclemcz/ban-pcdn-ip,https://github.com/unclemcz/ban-pcdn-ip,239,Êî∂ÈõÜÊÅ∂ÊÑèÂà∑ÂèñÁΩëÁ´ôCDNÊµÅÈáèÁöÑPCDN IPÊÆµÊ∏ÖÂçï„ÄÇ,The MIT License,0,0,3,0,2024-07-11
OpenGVLab/Diffree,https://github.com/OpenGVLab/Diffree,236,Diffree: Text-Guided Shape Free Object Inpainting with Diffusion Model,Apache License 2.0,0,0,3,0,2024-07-25
junjiehe96/UniPortrait,https://github.com/junjiehe96/UniPortrait,233,UniPortrait: A Unified Framework for Identity-Preserving Single- and Multi-Human Image Personalization,Apache License 2.0,0,0,3,0,2024-08-12
Quantweb3-com/NexusTrader,https://github.com/Quantweb3-com/NexusTrader,230,NexusTrader is a professional-grade open-source quantitative trading platform,The MIT License,0,0,3,0,2024-09-10
dylski/PaperPiAI,https://github.com/dylski/PaperPiAI,229,Raspberry Pi Zero powered AI-generated e-ink picture frame.,The MIT License,0,0,3,0,2024-12-10
ai8hyf/TF-ID,https://github.com/ai8hyf/TF-ID,228,TF-ID: Table/Figure IDentifier for academic papers,The MIT License,0,0,3,0,2024-07-11
bklieger-groq/g1,https://github.com/bklieger-groq/g1,4179,g1: Using Llama-3.1 70b on Groq to create o1-like reasoning chains,The MIT License,0,0,2,0,2024-09-13
lds133/weather_landscape,https://github.com/lds133/weather_landscape,1612,Visualizing Weather Forecasts Through Landscape Imagery,The MIT License,0,0,2,0,2024-09-20
16131zzzzzzzz/EveryoneNobel,https://github.com/16131zzzzzzzz/EveryoneNobel,1204,A flexible framework powered by ComfyUI for generating personalized Nobel Prize images.,Apache License 2.0,0,0,2,0,2024-10-20
facebookresearch/coconut,https://github.com/facebookresearch/coconut,872,Training Large Language Model to Reason in a Continuous Latent Space,The MIT License,0,0,2,0,2025-01-15
callmesora/llmops-python-package,https://github.com/callmesora/llmops-python-package,838,"Kickstart your LLMOps initiative with a flexible, robust, and productive Python package.",The MIT License,0,0,2,0,2024-12-10
TAG-Research/TAG-Bench,https://github.com/TAG-Research/TAG-Bench,673,TAG-Bench: A benchmark for table-augmented generation (TAG),The MIT License,0,0,2,0,2024-08-26
v3ucn/CosyVoice_For_Windows,https://github.com/v3ucn/CosyVoice_For_Windows,596,CosyVoiceÂú®WindowsÁéØÂ¢É‰∏ã‰ΩøÁî®ÁöÑÁâàÊú¨,Apache License 2.0,0,0,2,0,2024-07-07
microsoft/PIKE-RAG,https://github.com/microsoft/PIKE-RAG,551,PIKE-RAG: sPecIalized KnowledgE and Rationale Augmented Generation,The MIT License,0,0,2,0,2024-09-26
NVIDIA-AI-Blueprints/pdf-to-podcast,https://github.com/NVIDIA-AI-Blueprints/pdf-to-podcast,527,Transform PDFs into AI podcasts for engaging on-the-go audio content.,Apache License 2.0,0,0,2,0,2024-12-12
lucasnewman/f5-tts-mlx,https://github.com/lucasnewman/f5-tts-mlx,475,Implementation of F5-TTS in MLX,The MIT License,0,0,2,0,2024-10-13
sentient-engineering/jobber,https://github.com/sentient-engineering/jobber,475,browser controlling AI agent that applies to relavant jobs on internet autonomously. join chat @ https://discord.gg/umgnyQU2K8,The MIT License,0,0,2,0,2024-08-17
amzxyz/RIME-LMDG,https://github.com/amzxyz/RIME-LMDG,449,"RimeËæìÂÖ•Ê≥ïËØ≠Ê≥ïÊ®°ÂûãÂÖ®ÊµÅÁ®ãÊûÑÂª∫ÊïôÁ®ãÔºåÂÖ®Â±ÄÂ∏¶Â£∞Ë∞ÉËØçÂ∫ìÔºåÊúÄÂÖ®Â∏¶ËØªÈü≥ÂçïÂ≠óË°®ËØçÂÖ∏ÔºöLMDG - Language, Model, Dictionary, Grammar",Creative Commons Attribution 4.0 International,0,0,2,0,2024-10-29
Stephen-SMJ/LAMBDA,https://github.com/Stephen-SMJ/LAMBDA,426,"This is the offical repository of paper ""LAMBDA: A large Model Based Data Agent"". https://www.polyu.edu.hk/ama/cmfai/lambda.html",The MIT License,0,0,2,0,2024-07-26
SaiAkhil066/DeepSeek-RAG-Chatbot,https://github.com/SaiAkhil066/DeepSeek-RAG-Chatbot,423,"100 % FREE, Private (No Internet) DeepSeek‚Äôs Advanced RAG: Boost Your RAG Chatbot: Hybrid Retrieval (BM25 + FAISS) + Neural Reranking + HyDeüöÄ",The MIT License,0,0,2,0,2025-01-30
mbird1258/Audio-Decomposition,https://github.com/mbird1258/Audio-Decomposition,407,,The MIT License,0,0,2,0,2024-07-17
baaivision/NOVA,https://github.com/baaivision/NOVA,386,[ICLR 2025] Autoregressive Video Generation without Vector Quantization,Apache License 2.0,0,0,2,0,2024-12-16
topcss/docker-pull-tar,https://github.com/topcss/docker-pull-tar,371,,The MIT License,0,0,2,0,2025-01-14
lucidrains/autoregressive-diffusion-pytorch,https://github.com/lucidrains/autoregressive-diffusion-pytorch,356,Implementation of Autoregressive Diffusion in Pytorch,The MIT License,0,0,2,0,2024-07-23
HarshJ23/Deeper-Seeker,https://github.com/HarshJ23/Deeper-Seeker,341,"Deeper Seeker is an simpler OSS version of OpenAI's latest Deep Research feature in ChatGPT.It is an agentic research tool to reason , create multi step tasks , synthesize data from multiple online resources and create neat reports ",The MIT License,0,0,2,0,2025-02-03
lucidrains/pi-zero-pytorch,https://github.com/lucidrains/pi-zero-pytorch,333,"Implementation of œÄ‚ÇÄ, the robotic foundation model architecture proposed by Physical Intelligence",The MIT License,0,0,2,0,2024-11-01
neuml/rag,https://github.com/neuml/rag,331,üöÄ Retrieval Augmented Generation (RAG) with txtai. Combine search and LLMs to find insights with your own data.,Apache License 2.0,0,0,2,0,2024-07-25
feder-cr/resume_render_from_job_description,https://github.com/feder-cr/resume_render_from_job_description,313,"Resume_Builder_AIHawk is a powerful Python tool that allows you to automatically customize your resume based on a job URL, ensuring it perfectly aligns with the job requirements and skills. With an interactive command-line interface, this tool makes it easy to navigate through options and select from various pre-defined styles",The MIT License,0,0,2,0,2024-08-15
google/slang-gaussian-rasterization,https://github.com/google/slang-gaussian-rasterization,311,,Apache License 2.0,0,0,2,0,2024-08-13
chadyi/Search-for-LLMAPI,https://github.com/chadyi/Search-for-LLMAPI,296,‰∏Ä‰∏™ËΩªÈáèÁ∫ßÁöÑ API Â¢ûÂº∫ÊúçÂä°Ôºå‰∏∫ÂêÑÂ§ßÊ®°Âûã API Ê∑ªÂä†ÂÆûÊó∂ËÅîÁΩëÊêúÁ¥¢ËÉΩÂäõÔºåËÆ© AI ÂõûÁ≠îÊõ¥Âä†ÂáÜÁ°Æ„ÄÅÂèäÊó∂„ÄÇ,The MIT License,0,0,2,0,2025-02-03
Pints-AI/1.5-Pints,https://github.com/Pints-AI/1.5-Pints,292,A compact LLM pretrained in 9 days by using high quality data,The MIT License,0,0,2,0,2024-08-06
neuml/annotateai,https://github.com/neuml/annotateai,291,üìù Automatically annotate papers using LLMs ,Apache License 2.0,0,0,2,0,2024-12-12
fate-ubw/RAGLAB,https://github.com/fate-ubw/RAGLAB,287,[EMNLP 2024: Demo Oral] RAGLAB: A Modular and Research-Oriented Unified Framework for Retrieval-Augmented Generation,The MIT License,0,0,2,0,2024-08-06
bytedance/HLLM,https://github.com/bytedance/HLLM,271,HLLM: Enhancing Sequential Recommendations via Hierarchical Large Language Models for Item and User Modeling,Apache License 2.0,0,0,2,0,2024-09-18
Seed3D/Dora,https://github.com/Seed3D/Dora,263,"Official repository for ""Dora: Sampling and Benchmarking for 3D Shape Variational Auto-Encoders""",Apache License 2.0,0,0,2,0,2024-12-23
ywyue/FiT3D,https://github.com/ywyue/FiT3D,262,[ECCV 2024] Improving 2D Feature Representations by 3D-Aware Fine-Tuning,The MIT License,0,0,2,0,2024-07-20
KellerJordan/Muon,https://github.com/KellerJordan/Muon,253,Muon optimizer: +~30% sample efficiency with <3% wallclock overhead,The MIT License,0,0,2,0,2024-11-09
ITSpecialist111/ai_automation_suggester,https://github.com/ITSpecialist111/ai_automation_suggester,238,"This custom Home Assistant integration automatically scans your entities, detects new devices, and uses AI (via cloud and local APIs) to suggest tailored automations. It supports multiple AI providers, including OpenAI, Anthropic, Google, Groq, LocalAI, and Ollama. The integration provides automation suggestions via persistent notifications.",The MIT License,0,0,2,0,2024-10-13
alexfazio/OpenPlexity-Pages,https://github.com/alexfazio/OpenPlexity-Pages,235,"SearchGPT / Perplexity Pages clone, but personalised for you.",The MIT License,0,0,2,0,2024-07-16
nasa-jpl/rosa,https://github.com/nasa-jpl/rosa,967,"ROSA ü§ñ is an AI Agent designed to interact with ROS1- and ROS2-based robotics systems using natural language queries. ROSA helps robot developers inspect, diagnose, understand, and operate robots.",Apache License 2.0,0,0,1,0,2024-08-05
Thytu/Agentarium,https://github.com/Thytu/Agentarium,898,"open-source framework for creating and managing simulations populated with AI-powered agents. It provides an intuitive platform for designing complex, interactive environments where agents can act, learn, and evolve.",Apache License 2.0,0,0,1,0,2024-12-20
plurai-ai/intellagent,https://github.com/plurai-ai/intellagent,864,"A framework for comprehensive diagnosis and optimization of agents using simulated, realistic synthetic interactions",Apache License 2.0,0,0,1,0,2024-10-28
ViggoZ/producthunt-daily-hot,https://github.com/ViggoZ/producthunt-daily-hot,766,Ëá™Âä®ÁîüÊàêÊØèÊó•Product HuntÁÉ≠Èó®‰∫ßÂìÅ‰∏≠ÊñáÊ¶úÂçïÔºåÂü∫‰∫éGitHub ActionsËá™Âä®Êèê‰∫§MarkdownÊñá‰ª∂,The MIT License,0,0,1,0,2024-08-08
goodreasonai/ScrapeServ,https://github.com/goodreasonai/ScrapeServ,677,A self-hosted API that takes a URL and returns a file with browser screenshots.,The MIT License,0,0,1,0,2025-02-05
seal-rg/recurrent-pretraining,https://github.com/seal-rg/recurrent-pretraining,583,Pretraining code for a large-scale depth-recurrent language model,Apache License 2.0,0,0,1,0,2025-02-07
Jonseed/ComfyUI-Detail-Daemon,https://github.com/Jonseed/ComfyUI-Detail-Daemon,561,"A port of muerrilla's sd-webui-Detail-Daemon as a node for ComfyUI, to adjust sigmas that control detail.",The MIT License,0,0,1,0,2024-10-25
byjlw/video-analyzer,https://github.com/byjlw/video-analyzer,544,"A comprehensive video analysis tool that combines computer vision, audio transcription, and natural language processing to generate detailed descriptions of video content. This tool extracts key frames from videos, transcribes audio content, and produces natural language descriptions of the video's content.",Apache License 2.0,0,0,1,0,2024-11-10
AGI-Arena/MARS,https://github.com/AGI-Arena/MARS,532,The official implementation of MARS: Unleashing the Power of Variance Reduction for Training Large Models,Apache License 2.0,0,0,1,0,2024-11-17
JackJuly/linkook,https://github.com/JackJuly/linkook,450,üîç An OSINT tool for discovering linked social accounts and associated emails across multiple platforms using a single username.,The MIT License,0,0,1,0,2025-01-30
jplhughes/bon-jailbreaking,https://github.com/jplhughes/bon-jailbreaking,439,Code release for Best-of-N Jailbreaking,The MIT License,0,0,1,0,2024-10-11
hustvl/DiffusionDrive,https://github.com/hustvl/DiffusionDrive,436,Truncated Diffusion Model for Real-Time End-to-End Autonomous Driving,The MIT License,0,0,1,0,2024-11-15
rail-berkeley/hil-serl,https://github.com/rail-berkeley/hil-serl,415,,Apache License 2.0,0,0,1,0,2024-10-14
harishsg993010/LLM-Reasoner,https://github.com/harishsg993010/LLM-Reasoner,407,Make any LLM to think like OpenAI o1 and deepseek R1,The MIT License,0,0,1,0,2025-01-25
vision-x-nyu/thinking-in-space,https://github.com/vision-x-nyu/thinking-in-space,383,Official repo and evaluation implementation of VSI-Bench,Apache License 2.0,0,0,1,0,2024-12-14
RayFernando1337/MLX-Auto-Subtitled-Video-Generator,https://github.com/RayFernando1337/MLX-Auto-Subtitled-Video-Generator,368,Generate accurate transcripts using Apple's MLX framework,The MIT License,0,0,1,0,2024-07-30
BandarLabs/clickclickclick,https://github.com/BandarLabs/clickclickclick,361,A framework to enable autonomous android and computer use using any LLM (local or remote),The MIT License,0,0,1,0,2024-12-16
LambdaLabsML/distributed-training-guide,https://github.com/LambdaLabsML/distributed-training-guide,351,Best practices & guides on how to write distributed pytorch training code,The MIT License,0,0,1,0,2024-07-31
huggingface/Math-Verify,https://github.com/huggingface/Math-Verify,351,,Apache License 2.0,0,0,1,0,2025-01-17
danilotpnta/Youtube-Whisper,https://github.com/danilotpnta/Youtube-Whisper,344,A Gradio app that transcribes YouTube videos using audio extraction and OpenAI‚Äôs Whisper model.,The MIT License,0,0,1,0,2024-09-12
souzatharsis/podcastfy-demo,https://github.com/souzatharsis/podcastfy-demo,327,podcastfy.ai gradio demo app,Apache License 2.0,0,0,1,0,2024-10-08
jina-ai/late-chunking,https://github.com/jina-ai/late-chunking,324,Code for explaining and evaluating late chunking (chunked pooling),Apache License 2.0,0,0,1,0,2024-08-06
mikumifa/cppTickerBuy,https://github.com/mikumifa/cppTickerBuy,324,cpp cp30 Êº´Â±ï Ê¥ªÂä® Êä¢Á•® Êó†Â∑ÆÂà´ Âêå‰∫∫Â±ï,The MIT License,0,0,1,0,2024-08-02
zserge/tinylangs,https://github.com/zserge/tinylangs,320,Real programming languages in 50 lines of code,The MIT License,0,0,1,0,2024-09-07
Evil0ctal/Fast-Powerful-Whisper-AI-Services-API,https://github.com/Evil0ctal/Fast-Powerful-Whisper-AI-Services-API,315,‚ö° ‰∏ÄÊ¨æÁî®‰∫éËá™Âä®ËØ≠Èü≥ËØÜÂà´ (ASR)„ÄÅÁøªËØëÁöÑÈ´òÊÄßËÉΩÂºÇÊ≠• API„ÄÇ‰∏çÈúÄË¶ÅË¥≠‰π∞Whisper APIÔºå‰ΩøÁî®Êú¨Âú∞ËøêË°åÁöÑWhisperÊ®°ÂûãËøõË°åÊé®ÁêÜÔºåÂπ∂ÊîØÊåÅÂ§öGPUÂπ∂ÂèëÔºåÈíàÂØπÂàÜÂ∏ÉÂºèÈÉ®ÁΩ≤ËøõË°åËÆæËÆ°„ÄÇËøòÂÜÖÁΩÆ‰∫ÜÂåÖÊã¨TikTok„ÄÅÊäñÈü≥Á≠âÁ§æ‰∫§Â™í‰ΩìÂπ≥Âè∞ÁöÑÁà¨Ëô´ÔºåÂèØÂÆûÁé∞Êù•Ëá™Â§ö‰∏™Á§æ‰∫§Âπ≥Âè∞ÁöÑÊó†ÁºùÂ™í‰ΩìÂ§ÑÁêÜÔºå‰∏∫Â™í‰ΩìÂÜÖÂÆπÊï∞ÊçÆËá™Âä®ÂåñÂ§ÑÁêÜÊèê‰æõ‰∫ÜÂº∫Â§ß‰∏îÂèØÊâ©Â±ïÁöÑËß£ÂÜ≥ÊñπÊ°à„ÄÇ,Apache License 2.0,0,0,1,0,2024-10-23
nevesnunes/z80-sans,https://github.com/nevesnunes/z80-sans,315,OpenType font that disassembles Z80 instructions,The MIT License,0,0,1,0,2024-08-25
8090-inc/xrx-core,https://github.com/8090-inc/xrx-core,292,Multi-modal conversational AI (xRx) system,Apache License 2.0,0,0,1,0,2024-09-15
LiberSonora/LiberSonora,https://github.com/LiberSonora/LiberSonora,269,"LiberSonoraÔºåÂØìÊÑè‚ÄúËá™Áî±ÁöÑÂ£∞Èü≥‚ÄùÔºåÊòØ‰∏Ä‰∏™ AI ËµãËÉΩÁöÑ„ÄÅÂº∫Â§ßÁöÑ„ÄÅÂºÄÊ∫êÊúâÂ£∞‰π¶Â∑•ÂÖ∑ÈõÜÔºåÂåÖÂê´Êô∫ËÉΩÂ≠óÂπïÊèêÂèñ„ÄÅAIÊ†áÈ¢òÁîüÊàê„ÄÅÂ§öËØ≠Ë®ÄÁøªËØëÁ≠âÂäüËÉΩÔºåÊîØÊåÅ GPU Âä†ÈÄü„ÄÅÊâπÈáèÁ¶ªÁ∫øÂ§ÑÁêÜ„ÄÇLiberSonora, meaning ""The Voice of Freedom,"" is an AI-powered robust open-source audiobook toolkit.",The MIT License,0,0,1,0,2024-12-28
AkenClub/ken-iMoutai-Script,https://github.com/AkenClub/ken-iMoutai-Script,245,ÈùíÈæôËÑöÊú¨ÔºåÂÆåÊàê iËåÖÂè∞ È¢ÑÁ∫¶Áî≥Ë¥≠„ÄÅÁôªÂΩï„ÄÅÁü≠‰ø°È™åËØÅÁ†Å„ÄÅËÄêÂäõÂÄºÂíåÂ∞èËåÖËøêÈ¢ÜÂèñ„ÄÅÊóÖË°å Á≠âÂäüËÉΩ,Apache License 2.0,0,0,1,0,2024-09-13
jimmyyhwu/tidybot2,https://github.com/jimmyyhwu/tidybot2,243,TidyBot++: An Open-Source Holonomic Mobile Manipulator for Robot Learning,The MIT License,0,0,1,0,2024-11-06
deliro/moka-py,https://github.com/deliro/moka-py,243,A high performance caching library for Python written in Rust,The MIT License,0,0,1,0,2024-11-01
cartesia-ai/edge,https://github.com/cartesia-ai/edge,237,On-device intelligence.,Apache License 2.0,0,0,1,0,2024-08-27
NVIDIA/logits-processor-zoo,https://github.com/NVIDIA/logits-processor-zoo,235,A collection of LogitsProcessors to customize and enhance LLM behavior for specific tasks.,Apache License 2.0,0,0,1,0,2024-11-15
gtls64/MontyHome-Hackers-Guide,https://github.com/gtls64/MontyHome-Hackers-Guide,231,Documentation and code for Hack the MontyHome device for extended applications.,The MIT License,0,0,1,0,2024-10-24
PhrozenIO/Arcane,https://github.com/PhrozenIO/Arcane,230,Arcane - A secure remote desktop application for Windows with the     particularity of having a server entirely written in PowerShell and     a cross-platform client (Python/QT6).,Apache License 2.0,0,0,1,0,2024-07-31
pneumaticapp/pneumaticworkflow,https://github.com/pneumaticapp/pneumaticworkflow,228,Free and source-available Apache 2.0 licensed lightweight workflow automation tool. ,Apache License 2.0,0,0,1,0,2024-10-11
PKU-YuanGroup/LLaVA-CoT,https://github.com/PKU-YuanGroup/LLaVA-CoT,1831,"LLaVA-CoT, a visual language model capable of spontaneous, systematic reasoning",Apache License 2.0,0,0,0,0,2024-11-17
Hoper-J/AI-Guide-and-Demos-zh_CN,https://github.com/Hoper-J/AI-Guide-and-Demos-zh_CN,1345,ËøôÊòØ‰∏Ä‰ªΩÂÖ•Èó®AI/LLMÂ§ßÊ®°ÂûãÁöÑÈÄêÊ≠•ÊåáÂçóÔºåÂåÖÂê´ÊïôÁ®ãÂíåÊºîÁ§∫‰ª£Á†ÅÔºåÂ∏¶‰Ω†‰ªéAPIËµ∞ËøõÊú¨Âú∞Â§ßÊ®°ÂûãÈÉ®ÁΩ≤ÂíåÂæÆË∞ÉÔºå‰ª£Á†ÅÊñá‰ª∂‰ºöÊèê‰æõKaggleÊàñColabÂú®Á∫øÁâàÊú¨ÔºåÂç≥‰æøÊ≤°ÊúâÊòæÂç°‰πüÂèØ‰ª•ËøõË°åÂ≠¶‰π†„ÄÇÈ°πÁõÆ‰∏≠ËøòÂºÄËÆæ‰∫Ü‰∏Ä‰∏™Â∞èÂûãÁöÑ‰ª£Á†ÅÊ∏∏‰πêÂú∫üé°Ôºå‰Ω†ÂèØ‰ª•Â∞ùËØïÂú®ÈáåÈù¢ÂÆûÈ™å‰∏Ä‰∫õÊúâÊÑèÊÄùÁöÑAIËÑöÊú¨„ÄÇÂêåÊó∂ÔºåÂåÖÂê´ÊùéÂÆèÊØÖ (HUNG-YI LEEÔºâ2024ÁîüÊàêÂºè‰∫∫Â∑•Êô∫ËÉΩÂØºËÆ∫ËØæÁ®ãÁöÑÂÆåÊï¥‰∏≠ÊñáÈïúÂÉè‰Ωú‰∏ö„ÄÇ,The MIT License,0,0,0,0,2024-09-10
chenzomi12/AIInfra,https://github.com/chenzomi12/AIInfra,1254,AIInfraÔºàAI Âü∫Á°ÄËÆæÊñΩÔºâÊåáAIÁ≥ªÁªü‰ªéÂ∫ïÂ±ÇËäØÁâáÁ≠âÁ°¨‰ª∂ÔºåÂà∞‰∏äÂ±ÇËΩØ‰ª∂Ê†àÊîØÊåÅAIÂ§ßÊ®°ÂûãËÆ≠ÁªÉÂíåÊé®ÁêÜ„ÄÇ,Apache License 2.0,0,0,0,0,2024-07-17
JJTech0130/TrollRestore,https://github.com/JJTech0130/TrollRestore,1042,TrollStore installer for iOS 17.0,The MIT License,0,0,0,0,2024-09-01
UCSC-VLAA/story-adapter,https://github.com/UCSC-VLAA/story-adapter,780,A Training-free Iterative Framework for Long Story Visualization,The MIT License,0,0,0,0,2024-08-10
MoonshotAI/MoBA,https://github.com/MoonshotAI/MoBA,747,MoBA: Mixture of Block Attention for Long-Context LLMs,The MIT License,0,0,0,0,2025-02-17
devrim/cloudflare-noip,https://github.com/devrim/cloudflare-noip,738,free alternative to paid dynamic DNS services like NoIP.com,The MIT License,0,0,0,0,2024-07-16
IntelLabs/RAG-FiT,https://github.com/IntelLabs/RAG-FiT,707,Framework for enhancing LLMs for RAG tasks using fine-tuning.,Apache License 2.0,0,0,0,0,2024-07-23
ohayonguy/PMRF,https://github.com/ohayonguy/PMRF,594,[ICLR 2025] Official implementation of Posterior-Mean Rectified Flow: Towards Minimum MSE Photo-Realistic Image Restoration,The MIT License,0,0,0,0,2024-09-30
OpenBMB/VisRAG,https://github.com/OpenBMB/VisRAG,592,Parsing-free RAG supported by VLMs,Apache License 2.0,0,0,0,0,2024-10-14
Pravko-Solutions/FlashLearn,https://github.com/Pravko-Solutions/FlashLearn,545,"Integrate LLM in any pipeline - fit/predict pattern, JSON driven flows, and built in concurency support.",The MIT License,0,0,0,0,2025-01-16
FractalXBT/free-ai-money-printer,https://github.com/FractalXBT/free-ai-money-printer,493,,The MIT License,0,0,0,0,2025-01-30
tmplink/nsfw_detector,https://github.com/tmplink/nsfw_detector,454,Solution for checking file if  contain NSFW content.,Apache License 2.0,0,0,0,0,2024-11-13
yj94/BinarySpy,https://github.com/yj94/BinarySpy,452,‰∏Ä‰∏™ÊâãÂä®ÊàñËá™Âä®patch shellcodeÂà∞‰∫åËøõÂà∂Êñá‰ª∂ÁöÑÂÖçÊùÄÂ∑•ÂÖ∑/A tool for manual or automatic patch shellcode into binary file oder to bypass AV.,The MIT License,0,0,0,0,2024-07-17
XiaomingX/indie-hacker-tools-plus,https://github.com/XiaomingX/indie-hacker-tools-plus,444,"‰∏∫Áã¨Á´ãÂºÄÂèëËÄÖÂáÜÂ§áÁöÑÁ≤æÈÄâÊäÄÊúØÊ†àÂíåÂ∑•ÂÖ∑‰ªìÂ∫ìÊù•‰∫ÜÔºÅËøôÈáåÊúâ‰Ω†ÊúÄÈúÄË¶ÅÁöÑÂ∑•ÂÖ∑ÔºåÂ∏Æ‰Ω†ÊèêÂçáÂºÄÂèëÊïàÁéá„ÄÅËäÇÁ∫¶ÊàêÊú¨ÔºåÊúÄÈáçË¶ÅÁöÑÊòØ‚Äî‚ÄîËøô‰∫õÂ∑•ÂÖ∑ÈÉΩÊòØÂ∏ÇÂú∫‰∏äÁÉ≠Èó®ÁöÑÔºåÁªèËøáÈ™åËØÅÁöÑ„ÄÇüöÄA curated collection of tech stacks and tools tailored for independent developers is here! these are proven, popular tools widely used in the industry. üöÄ",Apache License 2.0,0,0,0,0,2024-11-13
Clats97/ClatScope,https://github.com/Clats97/ClatScope,431,"ClatScope Info Tool ‚Äì The best and most versatile OSINT utility for retrieving geolocation, DNS, WHOIS, phone, email, data breach information and much more (60 features). Perfect for investigators, pentesters, or anyone looking for an effective reconnaissance / OSINT tool. CLI version is always released before the GUI version.",Apache License 2.0,0,0,0,0,2025-01-08
nirbar1985/ai-travel-agent,https://github.com/nirbar1985/ai-travel-agent,427,AI Travel Agent,The MIT License,0,0,0,0,2024-09-04
guanchuwang/redis-bench,https://github.com/guanchuwang/redis-bench,421,,Apache License 2.0,0,0,0,0,2024-07-25
TilmanGriesel/chipper,https://github.com/TilmanGriesel/chipper,408,"‚ú® AI interface for tinkerers (Ollama, Haystack RAG, Python)",The MIT License,0,0,0,0,2024-12-22
BGU-CS-VIL/WTConv,https://github.com/BGU-CS-VIL/WTConv,400,Wavelet Convolutions for Large Receptive Fields. ECCV 2024.,The MIT License,0,0,0,0,2024-07-06
ABexit/ASR-LLM-TTS,https://github.com/ABexit/ASR-LLM-TTS,397,"This is a speech interaction system built on an open-source model, integrating ASR, LLM, and TTS in sequence. The ASR model is SenceVoice, the LLM models are QWen2.5-0.5B/1.5B, and there are three TTS models: CosyVoice, Edge-TTS, and pyttsx3",Apache License 2.0,0,0,0,0,2024-11-12
NVIDIA/kvpress,https://github.com/NVIDIA/kvpress,397,LLM KV cache compression made easy,Apache License 2.0,0,0,0,0,2024-11-06
fmind/cookiecutter-mlops-package,https://github.com/fmind/cookiecutter-mlops-package,386,Start building and deploying Python packages and Docker images for MLOps tasks.,The MIT License,0,0,0,0,2024-07-28
dsa/fast-voice-assistant,https://github.com/dsa/fast-voice-assistant,373,‚ö° Insanely fast AI voice assistant with <500ms response times,The MIT License,0,0,0,0,2024-08-27
weavel-ai/Ape,https://github.com/weavel-ai/Ape,362,Your first AI prompt engineer,The MIT License,0,0,0,0,2024-08-05
heyangxu/Re-movery,https://github.com/heyangxu/Re-movery,361,Re-movery,The MIT License,0,0,0,0,2024-12-02
plageon/HtmlRAG,https://github.com/plageon/HtmlRAG,351,HtmlRAG: HTML is Better Than Plain Text for Modeling Retrieval Results in RAG Systems (WWW 2025),The MIT License,0,0,0,0,2024-08-28
adysec/IP_database,https://github.com/adysec/IP_database,346,IPÂú∞ÂùÄÂ∫ì | GeoLiteÊï∞ÊçÆÂ∫ìÊØèÊó•Êõ¥Êñ∞ÔºåÁ∫ØÁúüipÂ∫ìÊØèÊó•Êõ¥Êñ∞Ôºåip2regionÊØèÊó•Êõ¥Êñ∞Ôºå17monipdbÊØèÊó•Êõ¥Êñ∞Ôºåipv6wryÊØèÊó•Êõ¥Êñ∞ÔºåIPDBÊØèÊó•Êõ¥Êñ∞ÔºåDB-IPÊØèÊó•Êõ¥Êñ∞,Creative Commons 1.0 Universal,0,0,0,0,2024-07-03
jndean/LossRider,https://github.com/jndean/LossRider,324,"A plotting tool that outputs Line Rider maps, so you can watch a man on a sled scoot down your loss curves. üéø",The MIT License,0,0,0,0,2024-08-12
adonis-dym/memory_reduced_optimizer,https://github.com/adonis-dym/memory_reduced_optimizer,320,,Apache License 2.0,0,0,0,0,2024-10-09
AabyssZG/FindEverything,https://github.com/AabyssZG/FindEverything,306,ÂÜÖÁΩëÊ∏óÈÄèËøáÁ®ã‰∏≠ÊêúÂØªÊåáÂÆöÊñá‰ª∂ÂÜÖÂÆπÔºå‰ªéËÄåÊâæÂà∞Á™ÅÁ†¥Âè£ÁöÑ‰∏Ä‰∏™Â∞èÂ∑•ÂÖ∑,The MIT License,0,0,0,0,2024-08-12
GradientSpaces/LoopSplat,https://github.com/GradientSpaces/LoopSplat,296,"[3DV 2025, Oral] LoopSplat: Loop Closure by Registering 3D Gaussian Splats",The MIT License,0,0,0,0,2024-08-12
urani-trade/solana-mev-agent-py,https://github.com/urani-trade/solana-mev-agent-py,291,"Urani's first MEV agent template. It listens for batches, parses them, checks for P2P matches, and spins threads for best quotes through arbitrage in different AMMs.",The MIT License,0,0,0,0,2024-08-20
yoheinakajima/babyagi-2o,https://github.com/yoheinakajima/babyagi-2o,291,the simplest self-building general autonomous agent,The MIT License,0,0,0,0,2024-10-18
zhenzhiwang/HumanVid,https://github.com/zhenzhiwang/HumanVid,282,[NeurIPS D&B Track 2024] Official implementation of HumanVid,Creative Commons Attribution 4.0 International,0,0,0,0,2024-07-19
joshpocock/Stride-AI-Agents,https://github.com/joshpocock/Stride-AI-Agents,278,This Repo Is In Development. It will slowly but surely become one of the most potent repos available for open source AI agent code for n8n and other use cases that I cover in my YouTube videos. Star the repo to support and to stay up-to-date. Book a call with my team if you want AI agent DFY.,The MIT License,0,0,0,0,2024-10-06
ystemsrx/mini-nanoGPT,https://github.com/ystemsrx/mini-nanoGPT,271,One-click training of your own GPT. Training a GPT has never been easier. / ËÆ≠ÁªÉ‰∏Ä‰∏™GPTÂéüÊù•ÂèØ‰ª•Ëøô‰πàÁÆÄÂçïÔºü,The MIT License,0,0,0,0,2024-12-29
bird-bench/BIRD-CRITIC-1,https://github.com/bird-bench/BIRD-CRITIC-1,265,BIRD-CRITIC 1.0: Can Large Language Models Solve USER SQL Issues in Real-World Database Applications?,The MIT License,0,0,0,0,2025-01-28
Gen-Verse/ReasonFlux,https://github.com/Gen-Verse/ReasonFlux,264,ReasonFlux: Hierarchical LLM Reasoning via Scaling Thought Templates,Apache License 2.0,0,0,0,0,2025-02-10
jblanked/FlipperHTTP,https://github.com/jblanked/FlipperHTTP,263,"Flipper Zero HTTP Library for the WiFi Developer Board, Raspberry Pi, and other ESP32 devices",The MIT License,0,0,0,0,2024-10-28
superbro423/sol_copy_trade-v1-28,https://github.com/superbro423/sol_copy_trade-v1-28,261,"‚ö†Ô∏èSolana Raydium Copy Trade Bot‚ö†Ô∏è 1 BLOCK SPEED SOLANA VOLUME BOT. Dominate the Solana ecosystem. Automate. Analyze. Win. This Solana CopyTrading Bot Supports PumpFun, Raydium to copy trade in 1 block. If you need Sol Volume Bot, Contact me. Solana Copy Trading Bot Solana Volume Bot Solana Copy Trading Bot Solana Copy Trading",The MIT License,0,0,0,0,2025-02-07
lazyFrogLOL/llmdocparser,https://github.com/lazyFrogLOL/llmdocparser,257,A package for parsing PDFs and analyzing their content using LLMs.,The MIT License,0,0,0,0,2024-07-26
pengfeng/ask.py,https://github.com/pengfeng/ask.py,254,A simple Python program to implement the search-extract-summarize flow.,The MIT License,0,0,0,0,2024-10-17
fabriziosalmi/patterns,https://github.com/fabriziosalmi/patterns,253,"Automated OWASP CRS and Bad Bot Detection for Nginx, Apache, Traefik and HaProxy",The MIT License,0,0,0,0,2024-12-21
neural-maze/ai-companion,https://github.com/neural-maze/ai-companion,251,"Meet Ava, the WhatsApp Agent",The MIT License,0,0,0,0,2024-12-17
mobiusml/gemlite,https://github.com/mobiusml/gemlite,238,Fast low-bit matmul kernels in Triton,Apache License 2.0,0,0,0,0,2024-07-03
taylorai/aiq,https://github.com/taylorai/aiq,238,ai for jq,The MIT License,0,0,0,0,2024-09-20
markuman/sms,https://github.com/markuman/sms,231,simple mbtiles server,The MIT License,0,0,0,0,2024-08-06
SiriusNEO/Triton-Puzzles-Lite,https://github.com/SiriusNEO/Triton-Puzzles-Lite,229,"Puzzles for learning Triton, play it with minimal environment configuration!",Apache License 2.0,0,0,0,0,2024-11-07
swarmzero/swarmzero,https://github.com/swarmzero/swarmzero,229,"SwarmZero's SDK for building AI agents, swarms of agents and much more.",Apache License 2.0,0,0,0,0,2024-08-09
