name,url,stars,description,license,question_issues,help_wanted_issues,total_issues,community_score,created_at
mdazfar2/Ezyshop,https://github.com/mdazfar2/Ezyshop,157,"EzyShop is a user-friendly platform that connects you to local stores, offering a seamless shopping experience. Compare prices, access exclusive deals, and enjoy hassle-free deliveries for groceries, essentials, and organic products‚Äîall in one app.",Apache License 2.0,39,3,11,42,2024-09-26
cline/cline,https://github.com/cline/cline,30122,"Autonomous coding agent right in your IDE, capable of creating/editing files, executing commands, using the browser, and more with your permission every step of the way.",Apache License 2.0,0,24,400,24,2024-07-06
ghostty-org/website,https://github.com/ghostty-org/website,181,"Ghostty website. For the source to the Ghostty project, please see https://github.com/ghostty-org/ghostty",The MIT License,0,24,11,24,2024-07-26
hmpl-language/hmpl,https://github.com/hmpl-language/hmpl,147,üêú Server-oriented customizable templating for JavaScript. Apply SSR without robots on any site!,The MIT License,0,24,6,24,2024-11-04
t0bst4r/home-assistant-matter-hub,https://github.com/t0bst4r/home-assistant-matter-hub,675,Publish your Home-Assistant Instance using Matter.,Apache License 2.0,18,0,74,18,2024-09-16
i-am-bee/beeai-framework,https://github.com/i-am-bee/beeai-framework,1805,Build production-ready AI agents in both Python and Typescript,Apache License 2.0,11,7,42,18,2024-08-23
voideditor/void,https://github.com/voideditor/void,10199,,Apache License 2.0,14,3,57,17,2024-09-11
lmnr-ai/lmnr,https://github.com/lmnr-ai/lmnr,1621,"Laminar - open-source all-in-one platform for engineering AI products. Crate data flywheel for you AI app. Traces, Evals, Datasets, Labels. YC S24.",Apache License 2.0,6,8,23,14,2024-08-29
oxdc/obsidian-vertical-tabs,https://github.com/oxdc/obsidian-vertical-tabs,229,"An Obsidian plugin that displays open tabs vertically, allowing users to group and organize tabs for a better navigation experience.",The MIT License,3,11,5,14,2024-07-20
opennextjs/opennextjs-cloudflare,https://github.com/opennextjs/opennextjs-cloudflare,599,Open Next.js adapter for Cloudflare,The MIT License,3,9,51,12,2024-09-12
obsidianmd/obsidian-clipper,https://github.com/obsidianmd/obsidian-clipper,1565,Highlight and capture the web in your favorite browser. The official Web Clipper extension for Obsidian.,The MIT License,0,11,97,11,2024-08-29
LauZzL/ltzj-nem,https://github.com/LauZzL/ltzj-nem,114,LTZJ-NEM Build 3„ÄÇ,The MIT License,10,0,9,10,2024-09-06
a-ghorbani/pocketpal-ai,https://github.com/a-ghorbani/pocketpal-ai,2447,An app that brings language models directly to your phone.,The MIT License,8,1,49,9,2024-08-25
Thavarshan/comet,https://github.com/Thavarshan/comet,149,"‚òÑÔ∏è A cross-platform desktop app powered by FFmpeg for easy, beautiful media conversion.",The MIT License,1,8,0,9,2024-08-10
sourcebot-dev/sourcebot,https://github.com/sourcebot-dev/sourcebot,1677,"Blazingly fast code search üèéÔ∏è  Deployed as a single Docker image üì¶ Search million+ lines of code in your GitHub, GitLab, Gitea, and Gerrit repositories ü™Ñ MIT licensed ‚úÖ",The MIT License,6,0,48,6,2024-08-23
techblitzdev/TechBlitz,https://github.com/techblitzdev/TechBlitz,323,"The open-source, mobile-friendly software education platform providing personalized coding challenges to everyone.",Apache License 2.0,6,0,39,6,2024-09-10
astral-sh/setup-uv,https://github.com/astral-sh/setup-uv,308,Set up your GitHub Actions workflow with a specific version of https://docs.astral.sh/uv/,The MIT License,0,6,22,6,2024-08-23
vault-developer/event-loop-explorer,https://github.com/vault-developer/event-loop-explorer,355,Event Loop Explorer: visualise javascript code execution in a browser environment,The MIT License,0,6,0,6,2024-08-04
anza-xyz/solana-web3.js,https://github.com/anza-xyz/solana-web3.js,193,Solana JavaScript SDK,The MIT License,4,1,45,5,2024-12-13
bytedance/UI-TARS-desktop,https://github.com/bytedance/UI-TARS-desktop,2737,A GUI Agent application based on UI-TARS(Vision-Lanuage Model) that allows you to control your computer using natural language.,Apache License 2.0,5,0,39,5,2025-01-19
Viren070/AIOStreams,https://github.com/Viren070/AIOStreams,155,"Combine all your streams into one addon and display them with consistent formatting, sorting, and filtering",The MIT License,3,2,23,5,2024-12-22
dostonnabotov/quicksnip,https://github.com/dostonnabotov/quicksnip,349,"Find code snippets in seconds, across multiple languages.",The MIT License,1,4,20,5,2024-10-27
rag-web-ui/rag-web-ui,https://github.com/rag-web-ui/rag-web-ui,1909,RAG Web UI is an intelligent dialogue system based on RAG (Retrieval-Augmented Generation) technology.,Apache License 2.0,2,3,19,5,2025-01-14
AmazonAppDev/react-native-multi-tv-app-sample,https://github.com/AmazonAppDev/react-native-multi-tv-app-sample,147,"üì∫üöÄ React Native TV app sample for Android TV, Fire TV, tvOS, and web. Features customizable drawer navigation üóÇÔ∏è, content grid üñºÔ∏è, hero header ü¶∏‚Äç‚ôÇÔ∏è, and video player üé•. Built with Expo. Perfect starter for cross-platform TV app development! üåü",MIT No Attribution,0,5,14,5,2024-07-17
SuperchupuDev/tinyglobby,https://github.com/SuperchupuDev/tinyglobby,279,A fast and minimal alternative to globby and fast-glob,The MIT License,2,3,12,5,2024-07-22
AstroX11/Xstro,https://github.com/AstroX11/Xstro,138,"Simple, Open source WhatsApp bot.",The MIT License,0,5,0,5,2024-11-02
yamadashy/repomix,https://github.com/yamadashy/repomix,9701,"üì¶ Repomix (formerly Repopack) is a powerful tool that packs your entire repository into a single, AI-friendly file. Perfect for when you need to feed your codebase to Large Language Models (LLMs) or other AI tools like Claude, ChatGPT, DeepSeek, Perplexity, Gemini, Gemma, Llama, Grok, and more.",The MIT License,4,0,54,4,2024-07-13
opentiny/tiny-editor,https://github.com/opentiny/tiny-editor,232,"TinyEditor is a rich text editor based on Quill 2.0, which extends rich modules and formats on the basis of Quill. It is powerful and out-of-the-box. TinyEditor ÊòØ‰∏Ä‰∏™Âü∫‰∫é Quill 2.0 ÁöÑÂØåÊñáÊú¨ÁºñËæëÂô®ÔºåÂú® Quill Âü∫Á°Ä‰∏äÊâ©Â±ï‰∫Ü‰∏∞ÂØåÁöÑÊ®°ÂùóÂíåÊ†ºÂºèÔºåÂäüËÉΩÂº∫Â§ß„ÄÅÂºÄÁÆ±Âç≥Áî®„ÄÇ",The MIT License,3,1,27,4,2024-08-12
codexu/note-gen,https://github.com/codexu/note-gen,748,‰∏ÄÊ¨æ‰∏ìÊ≥®‰∫éËÆ∞ÂΩïÂíåÂÜô‰ΩúÁöÑË∑®Á´Ø AI Á¨îËÆ∞,The MIT License,4,0,17,4,2024-08-06
gunnartorfis/sonner-native,https://github.com/gunnartorfis/sonner-native,589,An opinionated toast component for React Native. A port of @emilkowalski's sonner.,The MIT License,4,0,7,4,2024-09-03
cameronking4/openai-realtime-api-nextjs,https://github.com/cameronking4/openai-realtime-api-nextjs,249,"Leverage the OpenAI Realtime API (12-17-2024) with this Next.js 15 starter template featuring shadcn/ui components, tool-calling & localization. Use starter to build Voice AI apps with WebRTC.",The MIT License,3,1,3,4,2024-12-19
elizaOS/eliza,https://github.com/elizaOS/eliza,14550,Autonomous agents for everyone,The MIT License,2,1,375,3,2024-07-09
NeurProjects/neur-app,https://github.com/NeurProjects/neur-app,447,The Intelligent Copilot for Solana,The MIT License,0,3,43,3,2024-12-22
fabrix-framework/fabrix,https://github.com/fabrix-framework/fabrix,128,,The MIT License,0,3,21,3,2024-08-16
BluDood/GlanceThing,https://github.com/BluDood/GlanceThing,248,Your CarThing as a glanceable action pad!,The MIT License,3,0,18,3,2024-10-23
ibelick/motion-primitives,https://github.com/ibelick/motion-primitives,3860,"UI kit to make beautiful, animated interfaces, faster. Customizable. Open Source.",The MIT License,0,3,13,3,2024-07-03
mazzzystar/tinymind,https://github.com/mazzzystar/tinymind,713,Tinymind - Write and sync your blog & thoughts with GitHub,The MIT License,0,3,13,3,2024-09-15
ferrucc-io/emoji-picker,https://github.com/ferrucc-io/emoji-picker,262,React Emoji picker component styled with Tailwind,The MIT License,0,3,8,3,2025-01-25
rphlmr/react-router-hono-server,https://github.com/rphlmr/react-router-hono-server,249,Remix with Hono in less than 10 seconds,The MIT License,3,0,8,3,2024-08-03
gtokman/corner-smoothing,https://github.com/gtokman/corner-smoothing,571,Ô£ø Apple-like smooth corners for Tailwind CSS.,The MIT License,0,3,5,3,2024-11-05
czue/bluesky-comments,https://github.com/czue/bluesky-comments,168,Add a comments thread to any page using bluesky.,The MIT License,3,0,4,3,2024-11-25
ieedan/jsrepo,https://github.com/ieedan/jsrepo,307,‚ôªÔ∏è The best way to reuse your code.,The MIT License,1,2,1,3,2024-09-07
obot-platform/obot,https://github.com/obot-platform/obot,112,Open source AI Agent Platform,Apache License 2.0,1,1,295,2,2024-09-05
sveltejs/cli,https://github.com/sveltejs/cli,314,The Svelte CLI,The MIT License,1,1,60,2,2024-08-15
Azure-Samples/aoai-realtime-audio-sdk,https://github.com/Azure-Samples/aoai-realtime-audio-sdk,769,Azure OpenAI code resources for using gpt-4o-realtime capabilities.,The MIT License,2,0,45,2,2024-10-01
modelcontextprotocol/typescript-sdk,https://github.com/modelcontextprotocol/typescript-sdk,1230,The official Typescript SDK for Model Context Protocol servers and clients,The MIT License,1,1,29,2,2024-09-24
FrancescoXX/rustcrab,https://github.com/FrancescoXX/rustcrab,429,An Open Source project with everything you need to learn about Rust.,The MIT License,2,0,24,2,2024-07-10
kubewall/kubewall,https://github.com/kubewall/kubewall,881,A single binary kubernetes dashboard to manage your multiple clusters.,Apache License 2.0,2,0,8,2,2024-09-10
WayneKeenan/ClintonCAT,https://github.com/WayneKeenan/ClintonCAT,368,Browser Extension for automatically searching Rossmann's Consumer Action Taskforce (CAT) articles for the current page being visited. ,The MIT License,0,2,8,2,2025-01-27
anAcc22/another_graph_editor,https://github.com/anAcc22/another_graph_editor,121,A graph editor,The MIT License,1,1,3,2,2024-08-09
frost-beta/sisi,https://github.com/frost-beta/sisi,544,Semantic Image Search CLI tool.,The MIT License,2,0,2,2,2024-09-14
Groupguanfang/arkTS,https://github.com/Groupguanfang/arkTS,163,‰∏™‰∫∫‰ΩøÁî®ÁöÑVSCodeÈ∏øËíôArkTSÊèí‰ª∂‚ú®‚úçÔ∏èÊîØÊåÅÂêÑÁßçË°•ÂÖ®/Ë∑≥ËΩ¨üòÅ VSCode HarmonyOS ArkTS plugin for personal use ‚ú® supports source code navigation and completion üòÅ,The MIT License,0,2,2,2,2025-02-02
cyberagiinc/DevDocs,https://github.com/cyberagiinc/DevDocs,144,Your Documentation Discovery Engine,Apache License 2.0,2,0,2,2,2025-01-15
getomni-ai/zerox,https://github.com/getomni-ai/zerox,9680,OCR & Document Extraction using vision models,The MIT License,0,1,53,1,2024-07-21
anultravioletaurora/Jellify,https://github.com/anultravioletaurora/Jellify,190,A free and open source music player for Jellyfin powered by React Native,The MIT License,1,0,52,1,2024-08-09
Comfy-Org/litegraph.js,https://github.com/Comfy-Org/litegraph.js,120,"A graph node engine and editor written in Javascript similar to PD or UDK Blueprints, comes with its own editor in HTML5 Canvas2D. The engine can run client side or server side using Node. It allows to export graphs as JSONs to be included in applications independently.",The MIT License,1,0,46,1,2024-07-05
elizaOS/agent-twitter-client,https://github.com/elizaOS/agent-twitter-client,1386,A Twitter client for agents-- no API key necessary,The MIT License,0,1,33,1,2024-07-12
modelcontextprotocol/specification,https://github.com/modelcontextprotocol/specification,406,The specification of the Model Context Protocol,The MIT License,1,0,29,1,2024-09-24
google-gemini/multimodal-live-api-web-console,https://github.com/google-gemini/multimodal-live-api-web-console,1794,A react-based starter app for using the Multimodal Live API over websockets with Gemini,Apache License 2.0,1,0,24,1,2024-12-09
code100x/tiplink,https://github.com/code100x/tiplink,182,,The MIT License,0,1,21,1,2024-07-30
event-driven-io/Pongo,https://github.com/event-driven-io/Pongo,1252,Pongo - Mongo but on Postgres and with strong consistency benefits,The MIT License,1,0,20,1,2024-07-05
FellouAI/eko,https://github.com/FellouAI/eko,2565,Eko (Eko Keeps Operating) - Build Production-ready Agentic Workflow with Natural Language - eko.fellou.ai,The MIT License,0,1,18,1,2024-11-23
modelcontextprotocol/inspector,https://github.com/modelcontextprotocol/inspector,344,Visual testing tool for MCP servers,The MIT License,1,0,18,1,2024-10-03
clairefro/obsidian-plugin-chronos,https://github.com/clairefro/obsidian-plugin-chronos,129,Render interactive timelines in your Obsidian notes from simple Markdown.,The MIT License,0,1,17,1,2024-10-29
dlants/magenta.nvim,https://github.com/dlants/magenta.nvim,164,A tool-use-focused LLM plugin for neovim.,The MIT License,0,1,16,1,2024-12-02
rhinobase/hono-openapi,https://github.com/rhinobase/hono-openapi,427,A plugin for Hono to generate OpenAPI Swagger documentation,The MIT License,1,0,15,1,2024-10-11
barvian/number-flow,https://github.com/barvian/number-flow,5598,"An animated number component for React, Vue, and Svelte.",The MIT License,0,1,13,1,2024-07-15
metz-sh/simulacrum,https://github.com/metz-sh/simulacrum,420,Code-playground to visualise complex engineering flows.,Apache License 2.0,0,1,10,1,2024-08-07
filipsobol/sonda,https://github.com/filipsobol/sonda,405,Universal visualizer and analyzer for JavaScript and CSS. Compatible with most bundlers and frameworks,The MIT License,0,1,9,1,2024-08-10
fecommunity/reactpress,https://github.com/fecommunity/reactpress,373,üî• ReactPress is a free blog and CMS system developed using Next.js.ÔºàReactPressÊòØ‰∏Ä‰∏™Âü∫‰∫éNext.jsÁöÑÂçöÂÆ¢&CMSÁ≥ªÁªüÔºâ Live demoÔºöhttps://blog.gaoredu.com,The MIT License,0,1,8,1,2024-09-08
unnoq/orpc,https://github.com/unnoq/orpc,327,Typesafe API's Made Simple ü™Ñ,The MIT License,1,0,8,1,2024-09-27
authsmith/payload-auth-plugin,https://github.com/authsmith/payload-auth-plugin,144,Authentication plugin for Payload CMS,The MIT License,0,1,7,1,2024-07-11
aptakube/kubespec.dev,https://github.com/aptakube/kubespec.dev,347,Kubernetes Spec Explorer,The MIT License,0,1,6,1,2024-10-06
ropali/dockyard,https://github.com/ropali/dockyard,266,A fast & beautiful Docker GUI client,The MIT License,0,1,6,1,2024-07-11
rairprotocol/rair-sdk,https://github.com/rairprotocol/rair-sdk,1669,Simple developer SDK for RAIRprotocol,Apache License 2.0,0,1,5,1,2024-09-27
irsyadadl/justd,https://github.com/irsyadadl/justd,1097,"Justd is a chill set of React components, built on top of React Aria Components and Tailwind CSS. Easy to customize and just copy & paste into your React projects.",The MIT License,0,1,5,1,2024-07-05
mbarinov/repogpt,https://github.com/mbarinov/repogpt,248,"RepoGPT: AI-powered GitHub assistant to chat, manage, and explore your repos effortlessly.",The MIT License,0,1,5,1,2024-10-08
stackblitz-labs/use-stick-to-bottom,https://github.com/stackblitz-labs/use-stick-to-bottom,195,"A lightweight React Hook intended mainly for AI chat applications, for smoothly sticking to bottom of messages",The MIT License,0,1,3,1,2024-09-07
hamster1963/nezha-dash,https://github.com/hamster1963/nezha-dash,1266,A simple dashboard for nezha.,Apache License 2.0,0,1,1,1,2024-07-26
99percentpeople/weblink,https://github.com/99percentpeople/weblink,456,"A browser-based P2P chat and file transfer app with integrated screen sharing, powered by WebRTC.",The MIT License,0,1,1,1,2024-08-16
Logging-Stuff/RetroUI,https://github.com/Logging-Stuff/RetroUI,269,A retro-styled UI library for modern web applications.,The MIT License,0,1,0,1,2024-08-31
stackblitz/bolt.new,https://github.com/stackblitz/bolt.new,12922,"Prompt, run, edit, and deploy full-stack web applications",The MIT License,0,0,4395,0,2024-09-24
ArweaveOasis/Arweave-Academy,https://github.com/ArweaveOasis/Arweave-Academy,712,"Your one-stop journey to mastering Arweave AO development, organized by ArweaveOasis.",The MIT License,0,0,2255,0,2024-12-20
xynehq/xyne,https://github.com/xynehq/xyne,438,AI-first Search & Answer Engine for work. Open-source alternative to Glean.,Apache License 2.0,0,0,94,0,2024-09-02
anthropics/anthropic-quickstarts,https://github.com/anthropics/anthropic-quickstarts,7664,A collection of projects designed to help developers quickly get started with building deployable applications using the Anthropic API,The MIT License,0,0,93,0,2024-08-29
aidenybai/react-scan,https://github.com/aidenybai/react-scan,15370,Scan for React performance issues and eliminate slow renders in your app,The MIT License,0,0,80,0,2024-09-02
raidendotai/cofounder,https://github.com/raidendotai/cofounder,6164,"ai-generated apps , full stack + generative UI",The MIT License,0,0,69,0,2024-09-19
t3dotgg/quickpic,https://github.com/t3dotgg/quickpic,1117,Turn SVGs into high resolution PNGs in 2 clicks,The MIT License,0,0,61,0,2024-10-06
APIParkLab/APIPark,https://github.com/APIParkLab/APIPark,940,"ü¶ÑAPIPark is the #1 open-source AI Gateway and Developer Portal, enabling you to easily manage, integrate, and deploy AI and API services. APIPark seamlessly connects with various large AI models and packages these AI capabilities into APIs for easy invocation. ",Apache License 2.0,0,0,57,0,2024-08-12
dzhng/deep-research,https://github.com/dzhng/deep-research,12607,"An AI-powered research assistant that performs iterative, deep research on any topic by combining search engines, web scraping, and large language models.  The goal of this repo is to provide the simplest implementation of a deep research agent - e.g. an agent that can refine its research direction overtime and deep dive into a topic.",The MIT License,0,0,55,0,2025-02-04
callstackincubator/fabrice-ai,https://github.com/callstackincubator/fabrice-ai,263,"A lightweight, functional, and composable framework for building AI agents. No PhD required.",The MIT License,0,0,54,0,2024-12-06
LiRenTech/project-graph,https://github.com/LiRenTech/project-graph,1212,"üî• Draw fast, think efficiently. | A simple tool for drawing graphs.",The MIT License,0,0,51,0,2024-08-23
Nutlope/llamacoder,https://github.com/Nutlope/llamacoder,5504,Open source Claude Artifacts ‚Äì built with Llama 3.1 405B,The MIT License,0,0,48,0,2024-07-25
supabase-community/database-build,https://github.com/supabase-community/database-build,2677,In-browser Postgres sandbox with AI assistance (formerly postgres.new),Apache License 2.0,0,0,45,0,2024-07-22
sendaifun/solana-agent-kit,https://github.com/sendaifun/solana-agent-kit,989,connect any ai agents to solana protocols,Apache License 2.0,0,0,42,0,2024-11-17
langchain-ai/open-canvas,https://github.com/langchain-ai/open-canvas,3916,"üìÉ A better UX for chat, writing content, and coding with LLMs.",The MIT License,0,0,36,0,2024-10-03
glowingjade/obsidian-smart-composer,https://github.com/glowingjade/obsidian-smart-composer,1050,"AI chat assistant for Obsidian with contextual awareness, smart writing assistance, and one-click edits. Features vault-aware conversations, semantic search, and local model support.",The MIT License,0,0,36,0,2024-10-11
zuplo/zudoku,https://github.com/zuplo/zudoku,139,"Framework for building high quality, interactive API documentation.",The MIT License,0,0,36,0,2024-08-16
hunghg255/reactjs-tiptap-editor,https://github.com/hunghg255/reactjs-tiptap-editor,317,A modern WYSIWYG rich text editor based on tiptap and shadcn ui for Reactjs,The MIT License,0,0,35,0,2024-08-09
sammwyy/MikuMikuBeam,https://github.com/sammwyy/MikuMikuBeam,3875,An open-source network stresser tool but it's Hatsune Miku,The MIT License,0,0,34,0,2025-01-20
liam-hq/liam,https://github.com/liam-hq/liam,942,Automatically generates beautiful and easy-to-read ER diagrams from your database.,Apache License 2.0,0,0,34,0,2024-08-07
microsoft/code-push-server,https://github.com/microsoft/code-push-server,810,Standalone CodePush server from App Center,The MIT License,0,0,33,0,2024-09-25
corbt/agent.exe,https://github.com/corbt/agent.exe,3385,,The MIT License,0,0,30,0,2024-10-23
CorentinTh/enclosed,https://github.com/CorentinTh/enclosed,1218,Minimalistic web app designed for sending private and secure notes.,Apache License 2.0,0,0,29,0,2024-08-22
feige996/unibest,https://github.com/feige996/unibest,516,unibest - ÊúÄÂ•ΩÁî®ÁöÑ uniapp ÂºÄÂèëÊ°ÜÊû∂„ÄÇunibest ÊòØÁî± uniapp + Vue3 + Ts + Vite5 + UnoCss + WotUI È©±Âä®ÁöÑË∑®Á´ØÂø´ÈÄüÂêØÂä®Ê®°ÊùøÔºå‰ΩøÁî® VS Code ÂºÄÂèëÔºåÂÖ∑Êúâ‰ª£Á†ÅÊèêÁ§∫„ÄÅËá™Âä®Ê†ºÂºèÂåñ„ÄÅÁªü‰∏ÄÈÖçÁΩÆ„ÄÅ‰ª£Á†ÅÁâáÊÆµÁ≠âÂäüËÉΩÔºåÂêåÊó∂ÂÜÖÁΩÆ‰∫ÜÂ§ßÈáèÂπ≥Êó∂ÂºÄÂèëÂ∏∏Áî®ÁöÑÂü∫Êú¨ÁªÑ‰ª∂ÔºåÂºÄÁÆ±Âç≥Áî®ÔºåËÆ©‰Ω†ÁºñÂÜô uniapp Êã•Êúâ best ‰ΩìÈ™å„ÄÇ,The MIT License,0,0,29,0,2024-08-03
lee88688/aider-composer,https://github.com/lee88688/aider-composer,332,"Aider's VSCode extension, seamlessly integrated into VSCode ",Apache License 2.0,0,0,29,0,2024-11-11
inferablehq/inferable,https://github.com/inferablehq/inferable,328,Build distributed AI agents from your existing internal codebases with durable execution.,The MIT License,0,0,29,0,2024-10-25
Cloud-Code-AI/BrowserAI,https://github.com/Cloud-Code-AI/BrowserAI,822,"Run local LLMs like llama, deepseek-distill, kokoro and more inside your browser",The MIT License,0,0,28,0,2025-01-08
SanjulaGanepola/github-local-actions,https://github.com/SanjulaGanepola/github-local-actions,191,‚ú® Run your GitHub Actions locally in VS Code!,Apache License 2.0,0,0,27,0,2024-09-25
daydreamsai/daydreams,https://github.com/daydreamsai/daydreams,248,Daydreams is a generative agent framework for executing anything onchain,The MIT License,0,0,26,0,2024-12-20
wzc520pyfm/ant-design-x-vue,https://github.com/wzc520pyfm/ant-design-x-vue,109,Ant Design X For Vue. üî•,The MIT License,0,0,26,0,2024-12-30
romboHQ/tailwindcss-motion,https://github.com/romboHQ/tailwindcss-motion,2826,"tailwindcss-motion is a Tailwind CSS Plugin made at RomboHQ. It‚Äôs a simple, yet powerful, animation library with a simple syntax.",The MIT License,0,0,25,0,2024-09-20
IsaacGemal/wikitok,https://github.com/IsaacGemal/wikitok,1089,,The MIT License,0,0,25,0,2025-02-04
zaidmukaddam/scira,https://github.com/zaidmukaddam/scira,6307,Scira (Formerly MiniPerplx) is a minimalistic AI-powered search engine that helps you find information on the internet. Powered by Vercel AI SDK! Search with models like Grok 2.0.,The MIT License,0,0,24,0,2024-08-07
upstash/jstack,https://github.com/upstash/jstack,3251,"Build seriously fast, lightweight and end-to-end typesafe Next.js apps",The MIT License,0,0,24,0,2024-09-03
LegendApp/legend-list,https://github.com/LegendApp/legend-list,869,,The MIT License,0,0,24,0,2024-11-20
callstackincubator/cali,https://github.com/callstackincubator/cali,782,AI agent for building React Native apps,The MIT License,0,0,24,0,2024-11-23
CATProtocol/cat-token-box,https://github.com/CATProtocol/cat-token-box,195,A monorepo for packages implementing CAT protocol,The MIT License,0,0,24,0,2024-09-10
meltylabs/melty,https://github.com/meltylabs/melty,5344,Chat first code editor. To download the packaged app:,The MIT License,0,0,23,0,2024-09-02
ourongxing/newsnow,https://github.com/ourongxing/newsnow,3150,Elegant reading of real-time and hottest news,The MIT License,0,0,23,0,2024-09-23
arihantcodes/spectrum-ui,https://github.com/arihantcodes/spectrum-ui,241,Spectrum UI ‚≠ê is a collection of re-usable components built using Aceternity UI Magic UI and ShadCN UI that you can copy and paste into your apps.,Apache License 2.0,0,0,21,0,2024-10-19
eastlondoner/cursor-tools,https://github.com/eastlondoner/cursor-tools,2267,Give Cursor Agent an AI Team and Advanced Skills,The MIT License,0,0,20,0,2025-01-13
t3dotgg/unduck,https://github.com/t3dotgg/unduck,165,"A fast, local-first ""search engine"" for !bang users",The MIT License,0,0,20,0,2025-02-15
openai/openai-realtime-agents,https://github.com/openai/openai-realtime-agents,4994,"This is a simple demonstration of more advanced, agentic patterns built on top of the Realtime API.",The MIT License,0,0,19,0,2025-01-16
jodigiordano/gg,https://github.com/jodigiordano/gg,689,"The diagramming tool for flowcharts, mindmaps, user flows, network & cloud diagrams, and more!",The MIT License,0,0,19,0,2024-07-24
goat-sdk/goat,https://github.com/goat-sdk/goat,437,The open-source framework for connecting AI agents to any onchain app,The MIT License,0,0,19,0,2024-11-26
notionpresso/react,https://github.com/notionpresso/react,100,this is notion components for react,The MIT License,0,0,19,0,2024-09-15
elizaOS/eliza-starter,https://github.com/elizaOS/eliza-starter,293,,The MIT License,0,0,18,0,2024-11-20
unriddle-ai/lector,https://github.com/unriddle-ai/lector,238,"Simple, fast primitives for building pdf viewers. maintained by @unriddle-ai",The MIT License,0,0,18,0,2024-12-08
chasebank87/mesh-ai,https://github.com/chasebank87/mesh-ai,108,,The MIT License,0,0,18,0,2024-08-25
aws-samples/sample-client-for-amazon-bedrock,https://github.com/aws-samples/sample-client-for-amazon-bedrock,103,,MIT No Attribution,0,0,18,0,2024-07-03
webdevcody/wdc-saas-starter-kit,https://github.com/webdevcody/wdc-saas-starter-kit,1272,,The MIT License,0,0,17,0,2024-07-07
livekit-examples/realtime-playground,https://github.com/livekit-examples/realtime-playground,298,Play with OpenAI's new Realtime API in your browser,Apache License 2.0,0,0,17,0,2024-10-01
LayerXcom/next-navigation-guard,https://github.com/LayerXcom/next-navigation-guard,222,"Cancel page navigation in Next.js, like Nuxt's Navigation Guard feature.",The MIT License,0,0,17,0,2024-09-18
midday-ai/v1,https://github.com/midday-ai/v1,3364,An open-source starter kit based on Midday.,The MIT License,0,0,15,0,2024-08-29
ericciarla/trendFinder,https://github.com/ericciarla/trendFinder,2638,Stay on top of trending topics on social media and the web with AI,The MIT License,0,0,15,0,2024-12-31
bluesky-social/statusphere-example-app,https://github.com/bluesky-social/statusphere-example-app,190,An example atproto application using ExpressJS and Typescript.,The MIT License,0,0,15,0,2024-07-31
elematic/heximal,https://github.com/elematic/heximal,133,Heximal is a web-based interactive document and notebook system,The MIT License,0,0,15,0,2024-09-06
reaviz/reachat,https://github.com/reaviz/reachat,127,üí¨ UI Building Blocks for LLM/Chat UIs. Maintained by @goodcodeus.,Apache License 2.0,0,0,15,0,2024-07-18
anti-work/shortest,https://github.com/anti-work/shortest,4422,QA via natural language AI tests,The MIT License,0,0,14,0,2024-09-18
langchain-ai/social-media-agent,https://github.com/langchain-ai/social-media-agent,964,"üì≤ An agent for sourcing, curating, and scheduling social media posts with human-in-the-loop.",The MIT License,0,0,14,0,2024-11-21
leaper-one/MultiPost-Extension,https://github.com/leaper-one/MultiPost-Extension,384,,Apache License 2.0,0,0,14,0,2024-11-12
danielroe/beasties,https://github.com/danielroe/beasties,335,A library to inline your app's critical CSS and lazy-load the rest.,Apache License 2.0,0,0,14,0,2024-10-25
ammaarreshi/Gemini-Search,https://github.com/ammaarreshi/Gemini-Search,1895,Perplexity style AI Search engine clone built with Gemini 2.0 Flash and Grounding,The MIT License,0,0,13,0,2025-01-04
openstatusHQ/data-table-filters,https://github.com/openstatusHQ/data-table-filters,980,A playground for tanstack-table,The MIT License,0,0,13,0,2024-08-28
rairprotocol/rair-official-library,https://github.com/rairprotocol/rair-official-library,339,Simple dApps new users can deploy,Apache License 2.0,0,0,13,0,2024-07-23
e2b-dev/fragments,https://github.com/e2b-dev/fragments,3950,Open-source Next.js template for building apps that are fully generated by AI. By E2B.,Apache License 2.0,0,0,12,0,2024-07-10
steel-dev/steel-browser,https://github.com/steel-dev/steel-browser,3616,üî• Open Source Browser API for AI Agents & Apps. Steel Browser is a batteries-included browser instance that lets you automate the web without worrying about infrastructure.,Apache License 2.0,0,0,12,0,2024-11-01
jina-ai/node-DeepResearch,https://github.com/jina-ai/node-DeepResearch,2492,"Keep searching, reading webpages, reasoning until it finds the answer (or exceeding the token budget)",Apache License 2.0,0,0,12,0,2025-01-26
lowlighter/mizu,https://github.com/lowlighter/mizu,273,"üåä Lightweight, intuitive, and customizable JS library that makes building powerful web apps a breeze!",The MIT License,0,0,12,0,2024-10-08
takram-design-engineering/three-geospatial,https://github.com/takram-design-engineering/three-geospatial,131,Geospatial Rendering in Three.js,The MIT License,0,0,12,0,2024-08-30
coinbase/onchain-app-template,https://github.com/coinbase/onchain-app-template,120,,The MIT License,0,0,12,0,2024-08-05
livekit-examples/voice-assistant-frontend,https://github.com/livekit-examples/voice-assistant-frontend,101,A simple voice assistant example built with Next.js and LiveKit React Components,The MIT License,0,0,12,0,2024-09-11
530051970/auth-hub-demo,https://github.com/530051970/auth-hub-demo,99,User Identity Scaffolding  for Multiple OIDC Authentications for User ,Apache License 2.0,0,0,12,0,2024-08-12
tristcoil/hanabira.org,https://github.com/tristcoil/hanabira.org,98,Free Open-Source Japanese and Korean language learning portal. Allows for Self-Hosting. MIT License.,The MIT License,0,0,12,0,2024-12-14
hristo2612/SQLNoir,https://github.com/hristo2612/SQLNoir,628,Solve mysteries through SQL.,The MIT License,0,0,11,0,2025-02-04
haydenbleasel/kibo,https://github.com/haydenbleasel/kibo,553,"A custom registry of composable, accessible and open source shadcn/ui components.",The MIT License,0,0,11,0,2024-08-25
stacksjs/dtsx,https://github.com/stacksjs/dtsx,111,‚ö° Extremely fast & configurable DTS emitter.,The MIT License,0,0,11,0,2024-10-13
ethanniser/NextFaster,https://github.com/ethanniser/NextFaster,3858,A highly performant e-commerce template using Next.js ,The MIT License,0,0,10,0,2024-10-18
wechatferry/wechatferry,https://github.com/wechatferry/wechatferry,1421,Âü∫‰∫é WechatFerry ÁöÑÂæÆ‰ø°Êú∫Âô®‰∫∫Â∫ïÂ±ÇÊ°ÜÊû∂,The MIT License,0,0,10,0,2024-08-31
egoist/sitefetch,https://github.com/egoist/sitefetch,1085,Fetch an entire site and save it as a text file (to be used with AI models).,The MIT License,0,0,10,0,2025-01-07
addyosmani/squish,https://github.com/addyosmani/squish,668,Squish - Batch Browser-based Image Compression,The MIT License,0,0,10,0,2024-12-15
aidenybai/bippy,https://github.com/aidenybai/bippy,560,‚ö†Ô∏è hack into react internals,The MIT License,0,0,10,0,2024-12-03
svapnil/iso20022.js,https://github.com/svapnil/iso20022.js,341,"Create SEPA, FedNow, SWIFT, RTP payment initiations and process bank statements.",The MIT License,0,0,10,0,2024-07-16
supabase-community/snapshot,https://github.com/supabase-community/snapshot,279,Capture a snapshot (or subset) of your Postgres database whilst transforming the data.,The MIT License,0,0,10,0,2024-07-08
intergalacticalvariable/reader,https://github.com/intergalacticalvariable/reader,135,üìö This is an adapted version of Jina AI's Reader for local deployment using Docker. Convert any URL to an LLM-friendly input with a simple prefix http://127.0.0.1:3000/https://website-to-scrape.com/,Apache License 2.0,0,0,10,0,2024-09-28
dninomiya/full-calendar-for-shadcn-ui,https://github.com/dninomiya/full-calendar-for-shadcn-ui,99,,The MIT License,0,0,10,0,2024-08-26
richards199999/Thinking-Claude,https://github.com/richards199999/Thinking-Claude,14344,Let your Claude able to think,The MIT License,0,0,9,0,2024-11-13
nextjs/saas-starter,https://github.com/nextjs/saas-starter,10791,"Get started quickly with Next.js, Postgres, Stripe, and shadcn/ui.",The MIT License,0,0,9,0,2024-09-10
serafimcloud/21st,https://github.com/serafimcloud/21st,3646,"npm for design engineers: largest marketplace of shadcn/ui-based React Tailwind components, blocks and hooks",The MIT License,0,0,9,0,2024-09-30
unovue/motion-vue,https://github.com/unovue/motion-vue,1389,A animation library for Vue,The MIT License,0,0,9,0,2024-11-15
mjackson/remix-the-web,https://github.com/mjackson/remix-the-web,880,Open source tools for Remix (or any framework!),The MIT License,0,0,9,0,2024-07-12
google-gemini/starter-applets,https://github.com/google-gemini/starter-applets,744,Google AI Studio Starter Apps,Apache License 2.0,0,0,9,0,2024-12-09
bent2685/transok-wails,https://github.com/bent2685/transok-wails,454,An efficient LAN file sharing tool,The MIT License,0,0,9,0,2024-12-26
toss/use-funnel,https://github.com/toss/use-funnel,310,A powerful and safe step-by-step state management library at React,The MIT License,0,0,9,0,2024-07-25
harshsbhat/sealnotes,https://github.com/harshsbhat/sealnotes,228,Open-source lightweight encrypted notepad,The MIT License,0,0,9,0,2024-12-13
tinloof/medusa-dtc-starter-munchies,https://github.com/tinloof/medusa-dtc-starter-munchies,216,"This monorepo serves as a starter template/example for building B2C e-commerce applications using Medusa, Nextjs and Sanity",The MIT License,0,0,9,0,2024-10-02
ismamz/next-transition-router,https://github.com/ismamz/next-transition-router,190,Easily add animated transitions between pages using Next.js App Router and your favorite animation library.,The MIT License,0,0,9,0,2024-08-05
r-wasm/quarto-drop,https://github.com/r-wasm/quarto-drop,168,"Drop down an interactive R or Python console, code editor, and plotting window from the top of your Quarto slides.",The MIT License,0,0,9,0,2024-07-22
getprobo/probo,https://github.com/getprobo/probo,138,The open-source compliance platform,The MIT License,0,0,9,0,2025-01-07
teal-fm/teal,https://github.com/teal-fm/teal,111,"Your music, beautifully tracked. All yours. (coming soon)",The MIT License,0,0,9,0,2024-11-02
palantir/aip-community-registry,https://github.com/palantir/aip-community-registry,100,Collection of community-built applications and projects leveraging Palantir's AIP Platform.,Apache License 2.0,0,0,9,0,2024-12-19
gabriel-pineda/git-wrapped-api,https://github.com/gabriel-pineda/git-wrapped-api,1308,,The MIT License,0,0,8,0,2024-12-21
addyosmani/bg-remove,https://github.com/addyosmani/bg-remove,674,"Free image background removal - private, client-side and powered by Transformers.js",The MIT License,0,0,8,0,2024-11-01
chatmcp/mcp-directory,https://github.com/chatmcp/mcp-directory,338,directory for Awesome MCP Servers,Apache License 2.0,0,0,8,0,2024-12-06
olliethedev/ui-builder,https://github.com/olliethedev/ui-builder,307,"A React component that provides a no-code, visual way to create UIs, compatible with shadcn/ui and custom components.",The MIT License,0,0,8,0,2024-09-17
cloudflare/mcp-server-cloudflare,https://github.com/cloudflare/mcp-server-cloudflare,273,,Apache License 2.0,0,0,8,0,2024-11-27
VariantConst/OpenWebUI-Monitor,https://github.com/VariantConst/OpenWebUI-Monitor,251,A dashboard for tracking user activity and enforcing usage limits in OpenWebUI. Set user quotas efficiently.,The MIT License,0,0,8,0,2024-11-09
iuroc/bilidown,https://github.com/iuroc/bilidown,238,ÂìîÂì©ÂìîÂì©ËßÜÈ¢ëËß£Êûê‰∏ãËΩΩÂ∑•ÂÖ∑ÔºåÊîØÊåÅ 8K ËßÜÈ¢ë„ÄÅHi-Res Èü≥È¢ë„ÄÅÊùúÊØîËßÜÁïå‰∏ãËΩΩ„ÄÅÊâπÈáèËß£ÊûêÔºåÂèØÊâ´Á†ÅÁôªÂΩïÔºåÂ∏∏È©ªÊâòÁõò„ÄÇ,Apache License 2.0,0,0,8,0,2024-08-08
fpapado/svg-use,https://github.com/fpapado/svg-use,237,"Tools and bundler plugins, to ergonomically load SVG files via use[href]",The MIT License,0,0,8,0,2024-08-08
ocavue/astrobook,https://github.com/ocavue/astrobook,124,Minimal Storybook alternative,The MIT License,0,0,8,0,2024-08-02
z0ffy/vite-plugin-bundle-obfuscator,https://github.com/z0ffy/vite-plugin-bundle-obfuscator,105,JavaScript obfuscator plugin provides customizable options and multi-threaded support for Vite.,The MIT License,0,0,8,0,2024-07-23
idootop/MagicMirror,https://github.com/idootop/MagicMirror,1800,"ü™û Instant AI Face Swap, Hairstyles & Outfits ‚Äî One click to a brand new you! ‰∏ÄÈîÆ AI Êç¢ËÑ∏„ÄÅÂèëÂûã„ÄÅÁ©øÊê≠ÔºåÂèëÁé∞Êõ¥ÁæéÁöÑ‰Ω†",The MIT License,0,0,7,0,2024-11-11
fal-ai-community/video-starter-kit,https://github.com/fal-ai-community/video-starter-kit,1477,Enable AI models for video production in the browser,The MIT License,0,0,7,0,2024-12-19
Surfer-Org/Protocol,https://github.com/Surfer-Org/Protocol,1417,Open-source framework for exporting your personal data.,The MIT License,0,0,7,0,2024-08-09
qifi-dev/qrs,https://github.com/qifi-dev/qrs,1200,Stream data through multiple series of QR codes,The MIT License,0,0,7,0,2024-10-01
ggml-org/llama.vscode,https://github.com/ggml-org/llama.vscode,532,VS Code extension for LLM-assisted code/text completion,The MIT License,0,0,7,0,2025-01-06
alangrainger/obsidian-lazy-plugins,https://github.com/alangrainger/obsidian-lazy-plugins,325,"Load plugins with a delay on Obsidian startup, so that you can get your app startup down into the sub-second loading time.",The MIT License,0,0,7,0,2024-08-04
mary-ext/atcute,https://github.com/mary-ext/atcute,272,"a collection of lightweight TypeScript packages for AT Protocol, the protocol powering Bluesky.",The MIT License,0,0,7,0,2024-09-01
w3cj/next-start,https://github.com/w3cj/next-start,212,A basic Next.js starter.,The MIT License,0,0,7,0,2024-09-12
steel-dev/surf.new,https://github.com/steel-dev/surf.new,207,A playground for web agents üåä,The MIT License,0,0,7,0,2025-01-30
michaellatman/mcp-get,https://github.com/michaellatman/mcp-get,182,,The MIT License,0,0,7,0,2024-11-27
spaciousejar/learn-git-with-me,https://github.com/spaciousejar/learn-git-with-me,163,A free and open-source platform to learn Git and GitHub. It is designed to be simple and easy to understand for beginners.,The MIT License,0,0,7,0,2024-09-21
siddharthamaity/nextjs-15-starter-shadcn,https://github.com/siddharthamaity/nextjs-15-starter-shadcn,110,,The MIT License,0,0,7,0,2024-10-29
JackySoft/marsview,https://github.com/JackySoft/marsview,1423,"Marsview ÊòØ‰∏ÄÊ¨æ‰∏≠ÂêéÂè∞ÊñπÂêëÁöÑ‰Ωé‰ª£Á†ÅÂèØËßÜÂåñÊê≠Âª∫Âπ≥Âè∞ÔºåÂºÄÂèëËÄÖÂèØ‰ª•Âú®Âπ≥Âè∞‰∏äÂàõÂª∫È°πÁõÆ„ÄÅÈ°µÈù¢ÂíåÁªÑ‰ª∂ÔºåÊîØÊåÅ‰∫ã‰ª∂‰∫§‰∫í„ÄÅÊé•Âè£Ë∞ÉÁî®„ÄÅÊï∞ÊçÆËÅîÂä®ÂíåÈÄªËæëÁºñÊéíÁ≠âÔºåÂºÄÂèëËÄÖËøòÂèØÈÄöËøáÂæÆÊúçÂä°Âø´ÈÄüÈõÜÊàêÂà∞Ëá™Â∑±ÁöÑ‰∏öÂä°Á≥ªÁªü‰∏≠„ÄÇ   Marsview is a low code visualization platform for middle and backend direction, supporting event interaction, interface calling, data linkage, and logical orchestration.",Apache License 2.0,0,0,6,0,2024-08-04
jaypyles/Scraperr,https://github.com/jaypyles/Scraperr,1352,Self-hosted webscraper.,The MIT License,0,0,6,0,2024-07-06
xxss0903/drawstamputils,https://github.com/xxss0903/drawstamputils,1144,Draw Stamp Utils with Javascript,Apache License 2.0,0,0,6,0,2024-09-23
btahir/open-deep-research,https://github.com/btahir/open-deep-research,1125,Open source alternative to Gemini Deep Research. Generate reports with AI based on search results.,The MIT License,0,0,6,0,2024-12-24
desko27/react-call,https://github.com/desko27/react-call,773,‚öõÔ∏è üì° Call your React components,The MIT License,0,0,6,0,2024-08-10
bloomberg/stricli,https://github.com/bloomberg/stricli,771,Build complex CLIs with type safety and no dependencies,Apache License 2.0,0,0,6,0,2024-09-23
fdarkaou/open-deep-research,https://github.com/fdarkaou/open-deep-research,723,An open-source alternative to OpenAI and Gemini's deep research.,The MIT License,0,0,6,0,2025-02-07
beilunyang/moemail,https://github.com/beilunyang/moemail,709,‰∏Ä‰∏™Âü∫‰∫é NextJS + Cloudflare ÊäÄÊúØÊ†àÊûÑÂª∫ÁöÑÂèØÁà±‰∏¥Êó∂ÈÇÆÁÆ±ÊúçÂä°üéâ,The MIT License,0,0,6,0,2024-12-01
FoloUp/FoloUp,https://github.com/FoloUp/FoloUp,591,üíº Your own AI-powered voice interviewer for hiring.,The MIT License,0,0,6,0,2025-02-02
Mina-Massoud/next-ui-full-calendar,https://github.com/Mina-Massoud/next-ui-full-calendar,369,"next-ui-full-calendar, shadcn-ui-full-calendar",The MIT License,0,0,6,0,2024-10-13
vantuan88291/react-native-ota-hot-update,https://github.com/vantuan88291/react-native-ota-hot-update,320,"React native hot update same as code push, can update using git repository or custom server",The MIT License,0,0,6,0,2024-08-16
ethereum-optimism/superchainerc20-starter,https://github.com/ethereum-optimism/superchainerc20-starter,297,A starter kit for deploying and testing SuperchainERC20 tokens,The MIT License,0,0,6,0,2024-10-11
soybeanjs/soybean-admin-react,https://github.com/soybeanjs/soybean-admin-react,281,react-adminÂü∫‰∫éAntdÔºåÂäüËÉΩÂº∫Â§ß‰∏î‰∏∞ÂØåÔºåÈ°µÈù¢ÁæéËßÇÔºå‰ª£Á†Å‰ºòÈõÖ ,The MIT License,0,0,6,0,2024-08-08
haydenbleasel/orate,https://github.com/haydenbleasel/orate,253,The AI toolkit for speech.,The MIT License,0,0,6,0,2025-01-24
unjs/srvx,https://github.com/unjs/srvx,252,"üí• Universal Server API based on web platform standards. Works seamlessly with Deno, Bun and Node.js.",The MIT License,0,0,6,0,2024-09-16
raphaelsalaja/sylph,https://github.com/raphaelsalaja/sylph,238,"A minimal and lightweight portfolio template designed for developers, designers, and creatives.",The MIT License,0,0,6,0,2024-09-11
w3cj/stoker,https://github.com/w3cj/stoker,235,Utilities for hono and @hono/zod-openapi,The MIT License,0,0,6,0,2024-10-03
MiddleSchoolStudent/BotBrowser,https://github.com/MiddleSchoolStudent/BotBrowser,190,"BotBrowser modifies Chromium's C++ kernel to emulate a real browser, bypassing Cloudflare, F5 Shape, PerimeterX, Akamai, Kasada, and reCAPTCHA with unmatched stealth and reliability.",The MIT License,0,0,6,0,2024-09-08
aliceisjustplaying/labeler-starter-kit-bsky,https://github.com/aliceisjustplaying/labeler-starter-kit-bsky,153,Use this repository to get started with your own Bluesky Labeler.,The MIT License,0,0,6,0,2024-10-02
haydenbleasel/eververse,https://github.com/haydenbleasel/eververse,152,The open source product management platform.,The MIT License,0,0,6,0,2025-01-10
anondotworld/anonworld,https://github.com/anondotworld/anonworld,135,,The MIT License,0,0,6,0,2024-11-18
Murderlon/the-startup-stack,https://github.com/Murderlon/the-startup-stack,128,"Get independence from SaaS without loosing its developer experience, the infra primitives to adapt to any future requirement, and the tools  to build delightful, secure user experiences.",The MIT License,0,0,6,0,2024-10-02
rohitkumbhar/surmai,https://github.com/rohitkumbhar/surmai,123,Surmai is a personal/family travel organizer,The MIT License,0,0,6,0,2024-11-18
danielroe/zero-vue,https://github.com/danielroe/zero-vue,112,Vue bindings for Zero,The MIT License,0,0,6,0,2024-12-27
angular-architects/detective,https://github.com/angular-architects/detective,106,,The MIT License,0,0,6,0,2024-08-14
patruff/ollama-mcp-bridge,https://github.com/patruff/ollama-mcp-bridge,102,"Bridge between Ollama and MCP servers, enabling local LLMs to use Model Context Protocol tools",The MIT License,0,0,6,0,2024-12-12
pqoqubbw/icons,https://github.com/pqoqubbw/icons,3749,beautifully crafted animated icons,The MIT License,0,0,5,0,2024-10-31
FrigadeHQ/trench,https://github.com/FrigadeHQ/trench,1481,"Trench ‚Äî Open-Source Analytics Infrastructure. A single production-ready Docker image built on ClickHouse, Kafka, and Node.js for tracking events, page views. Easily build product analytics dashboards, LLM RAGs, observability platforms, or any other analytics product.",The MIT License,0,0,5,0,2024-09-30
rektdeckard/departure-mono,https://github.com/rektdeckard/departure-mono,1208,"A monospaced pixel font with a lo-fi, techy vibe",The MIT License,0,0,5,0,2024-07-25
mckaywrigley/mckays-app-template,https://github.com/mckaywrigley/mckays-app-template,1147,This is the template I use to start new full-stack projects.,The MIT License,0,0,5,0,2024-08-29
GitHamza0206/simba,https://github.com/GitHamza0206/simba,963, Portable KMS (knowledge management system) designed to integrate seamlessly with any Retrieval-Augmented Generation (RAG) system,Apache License 2.0,0,0,5,0,2024-12-20
callstackincubator/react-native-bottom-tabs,https://github.com/callstackincubator/react-native-bottom-tabs,841,Native Bottom Tabs for React Native,The MIT License,0,0,5,0,2024-09-27
byodian/oneimg,https://github.com/byodian/oneimg,675,ÊñáÂ≠óËΩ¨ÂõæÁâáÂ∫îÁî®„ÄÇÈÄÇÂêàÂæÆ‰ø°ÂÖ¨‰ºóÂè∑ÈïøÂõæÊé®Êñá‰ª•ÂèäÂ∞èÁ∫¢‰π¶„ÄÅInstagram Á≠âÂõæÁâáÁ§æ‰∫§Â™í‰ΩìË¥¥ÊñáÂà∂‰Ωú,The MIT License,0,0,5,0,2024-08-18
mckaywrigley/buildware-ai,https://github.com/mckaywrigley/buildware-ai,535,An experimental AI coding tool.,The MIT License,0,0,5,0,2024-07-10
CSS-Next/logo.css,https://github.com/CSS-Next/logo.css,417,,Creative Commons 1.0 Universal,0,0,5,0,2024-09-19
langchain-ai/agent-inbox,https://github.com/langchain-ai/agent-inbox,417,New user experiences for interacting with agents,The MIT License,0,0,5,0,2024-11-04
paper-design/shaders,https://github.com/paper-design/shaders,371,Zero-dependency canvas shaders that can be installed from npm or designed in Paper,The MIT License,0,0,5,0,2024-10-09
transitive-bullshit/openai-realtime-api,https://github.com/transitive-bullshit/openai-realtime-api,335,TypeScript client for OpenAI's realtime voice API.,The MIT License,0,0,5,0,2024-10-15
jefferson-calmon/codocx,https://github.com/jefferson-calmon/codocx,314,A ferramenta mais simples e f√°cil de usar para automatizar documenta√ß√£o de c√≥digo,The MIT License,0,0,5,0,2024-08-21
ChainBuff/solana-web3js,https://github.com/ChainBuff/solana-web3js,310,ÂèØÂø´ÈÄü‰∏äÊâãÁöÑ Solana Web3.js ÊïôÁ®ã,The MIT License,0,0,5,0,2024-10-19
Ahmet-Dedeler/ai-llm-comparison,https://github.com/Ahmet-Dedeler/ai-llm-comparison,294,A website where you can compare every AI Model ‚ú®,The MIT License,0,0,5,0,2024-09-18
Blazity/shadcn-chatbot-kit,https://github.com/Blazity/shadcn-chatbot-kit,287,ü§ñ Beautifully designed chatbot components based on shadcn/ui,The MIT License,0,0,5,0,2024-10-21
SukkaW/Make-Bilibili-Great-Than-Ever-Before,https://github.com/SukkaW/Make-Bilibili-Great-Than-Ever-Before,270,"A fork of the userscript ""Make Bilibili Great Again"", but with some experimental features",The MIT License,0,0,5,0,2024-12-22
saharmor/gemini-multimodal-playground,https://github.com/saharmor/gemini-multimodal-playground,257,Build realtime voice and video agents with Google's new Gemini 2.0 (API is free for now),Apache License 2.0,0,0,5,0,2024-12-13
medusajs/b2b-starter-medusa,https://github.com/medusajs/b2b-starter-medusa,201,Official Medusa B2B Starter template. Features common B2B ecommerce requirements and can be easily adapted and extended.,The MIT License,0,0,5,0,2024-09-17
callstackincubator/flows-ai,https://github.com/callstackincubator/flows-ai,200,Run AI workflows with TypeScript & Vercel AI SDK,The MIT License,0,0,5,0,2025-01-14
dotnetfactory/fluid-calendar,https://github.com/dotnetfactory/fluid-calendar,175,,The MIT License,0,0,5,0,2025-02-17
rishikanthc/markopolis,https://github.com/rishikanthc/markopolis,164,Markdown Programmable Interface,The MIT License,0,0,5,0,2024-07-31
aws-samples/well-architected-iac-analyzer,https://github.com/aws-samples/well-architected-iac-analyzer,160,,MIT No Attribution,0,0,5,0,2024-10-28
cloudflare/workers-mcp,https://github.com/cloudflare/workers-mcp,151,Talk to a Cloudflare Worker from Claude Desktop!,Apache License 2.0,0,0,5,0,2024-12-17
PaddleHQ/paddle-nextjs-starter-kit,https://github.com/PaddleHQ/paddle-nextjs-starter-kit,135,,Apache License 2.0,0,0,5,0,2024-09-16
awaLiny2333/LinysBrowser_NEXT,https://github.com/awaLiny2333/LinysBrowser_NEXT,132,A basic browser on HarmonyOS NEXT!,The MIT License,0,0,5,0,2024-09-05
snaggle-ai/openapi-mcp-server,https://github.com/snaggle-ai/openapi-mcp-server,131,,The MIT License,0,0,5,0,2024-12-07
vitonsky/arrival-time,https://github.com/vitonsky/arrival-time,115,Simple and powerful progress time estimation (ETA) for JavaScript,The MIT License,0,0,5,0,2024-08-03
lukaszkurantdev/react-native-fast-opencv,https://github.com/lukaszkurantdev/react-native-fast-opencv,115,A powerful port of OpenCV for React Native.,The MIT License,0,0,5,0,2024-08-03
inkonchain/ink-kit,https://github.com/inkonchain/ink-kit,32792,"Onchain-focused SDK with ready-to-use templates, themes, and magical animated components ‚ú®",The MIT License,0,0,4,0,2024-11-04
Nutlope/napkins,https://github.com/Nutlope/napkins,1056,napkins.dev ‚Äì from screenshot to app,The MIT License,0,0,4,0,2024-09-18
baturyilmaz/wordpecker-app,https://github.com/baturyilmaz/wordpecker-app,603," A personalized language-learning tool that combines Duolingo-style lessons with your own curated vocabulary lists. Seamlessly add words from books, articles, or videos, and revisit them through interactive quizzes and LLM-generated lessons. ",The MIT License,0,0,4,0,2025-01-20
w3cj/hono-open-api-starter,https://github.com/w3cj/hono-open-api-starter,490,A starter template for building fully documented type-safe JSON APIs with Hono and Open API,The MIT License,0,0,4,0,2024-10-04
WebDevSimplified/parity-deals-clone,https://github.com/WebDevSimplified/parity-deals-clone,436,,The MIT License,0,0,4,0,2024-09-16
jianjianai/FList,https://github.com/jianjianai/FList,330,"Â∞Ü GitHub Releases,Hugging Face,Êñá‰ª∂urlÁ≠âÔºåÊ∏≤ÊüìÊàêÁ±ª‰ººÁΩëÁõòÁöÑÊñá‰ª∂ÂàóË°®ÊòæÁ§∫Âú®ÁΩëÈ°µ‰∏äÔºåÊñπ‰æøÁî®Êà∑‰∏ãËΩΩÂºÄÊ∫êËΩØ‰ª∂„ÄÇ ÊîØÊåÅËßÜÈ¢ë„ÄÅÈü≥È¢ë„ÄÅÂõæÁâá„ÄÅPDF Á≠âÊñá‰ª∂ÁöÑÂú®Á∫øÈ¢ÑËßà„ÄÇ",The MIT License,0,0,4,0,2024-07-12
GeoRetina/chat2geo,https://github.com/GeoRetina/chat2geo,323,"Chat2Geo delivers a ChatGPT-like experience tailored for remote-sensing-based geospatial analysis. Its mission is to democratize geospatial insights at scale by harnessing cutting-edge AI technologies, making advanced analysis accessible to everyone.",The MIT License,0,0,4,0,2025-01-25
remvze/nothing,https://github.com/remvze/nothing,221,üï≥ Simply do nothing.,The MIT License,0,0,4,0,2024-09-15
rubickecho/n8n-deepseek,https://github.com/rubickecho/n8n-deepseek,213,"A user-friendly DeepSeek AI node, similar to OpenAI, designed to enhance your workflow.",The MIT License,0,0,4,0,2024-07-29
minusxai/minusx,https://github.com/minusxai/minusx,196,"MinusX is an AI Data Scientist for Analytics Apps you already use and love. Currently it supports Jupyter, Metabase, Google Sheets & Posthog.",The MIT License,0,0,4,0,2024-08-29
supabase-community/pg-gateway,https://github.com/supabase-community/pg-gateway,196,Postgres wire protocol for the server-side,The MIT License,0,0,4,0,2024-07-23
Natoune/SpotifyMobileLyricsAPI,https://github.com/Natoune/SpotifyMobileLyricsAPI,187,This API overrides the Spotify API endpoint used in the Spotify mobile app to fetch lyrics for the currently playing song.,The MIT License,0,0,4,0,2024-09-08
SamuelScheit/react-native-skia-list,https://github.com/SamuelScheit/react-native-skia-list,165,The fastest react-native list renderer based on @shopify/react-native-skia,The MIT License,0,0,4,0,2024-10-15
TimWitzdam/GitSave,https://github.com/TimWitzdam/GitSave,153,GitSave is a self-hosted and open-source application that backs up your Git repositories.,Apache License 2.0,0,0,4,0,2024-08-21
programming-with-ia/shadcn-theme-editor,https://github.com/programming-with-ia/shadcn-theme-editor,152,Shadcn Theme Editor is a user-friendly component designed to simplify the process of managing and customizing theme colors in Shadcn-based projects.,The MIT License,0,0,4,0,2024-08-10
RubixCube-Innovations/mantine-theme-builder,https://github.com/RubixCube-Innovations/mantine-theme-builder,141,"MantineHub(previously Mantine Theme Builder) is an open-source tool to create modern, customizable shadcn inspired themes for Mantine UI components. Easily adjust styles, colors, radius, and light/dark modes, and export the theme object for quick integration into any Mantine project.",The MIT License,0,0,4,0,2024-10-05
drbap/dashboard-navigator-for-obsidian,https://github.com/drbap/dashboard-navigator-for-obsidian,130,Dashboard navigator plugin for Obsidian.,The MIT License,0,0,4,0,2024-07-21
AIDC-AI/ComfyUI-Copilot,https://github.com/AIDC-AI/ComfyUI-Copilot,128,An AI-powered custom node for ComfyUI designed to enhance workflow automation and provide intelligent assistance,The MIT License,0,0,4,0,2025-02-14
MrLightful/shadcn-tree-view,https://github.com/MrLightful/shadcn-tree-view,127,A Shadcn UI component for hierarchical lists of data with nested levels that can be expanded and collapsed.,The MIT License,0,0,4,0,2024-09-10
webdevcody/survive-the-night-game,https://github.com/webdevcody/survive-the-night-game,118,Website,The MIT License,0,0,4,0,2024-11-18
w3cj/monorepo-example-tasks-app,https://github.com/w3cj/monorepo-example-tasks-app,115,,The MIT License,0,0,4,0,2024-12-24
OpenRouterTeam/ai-sdk-provider,https://github.com/OpenRouterTeam/ai-sdk-provider,113,The OpenRouter provider for the Vercel AI SDK contains support for hundreds of AI models through the OpenRouter chat and completion APIs.,Apache License 2.0,0,0,4,0,2024-07-18
xNomad-AI/mcv,https://github.com/xNomad-AI/mcv,112,A toolkit to launch your AI-NFT on multichain.,The MIT License,0,0,4,0,2024-12-27
Ejb503/multimodal-mcp-client,https://github.com/Ejb503/multimodal-mcp-client,104,A Multi-modal MCP client for voice powered agentic workflows,The MIT License,0,0,4,0,2025-01-08
kolenaIO/autoarena,https://github.com/kolenaIO/autoarena,102,"Rank LLMs, RAG systems, and prompts using automated head-to-head evaluation",Apache License 2.0,0,0,4,0,2024-08-28
addyosmani/video-compress,https://github.com/addyosmani/video-compress,99,Video compression in the browser using FFMPEG.wasm,The MIT License,0,0,4,0,2024-11-10
ahmedkhaleel2004/gitdiagram,https://github.com/ahmedkhaleel2004/gitdiagram,2521,Replace 'hub' with 'diagram' in any GitHub url to instantly visualize the codebase as an interactive diagram,The MIT License,0,0,3,0,2024-12-15
romansky/dom-to-semantic-markdown,https://github.com/romansky/dom-to-semantic-markdown,755,DOM to Semantic-Markdown for use with LLMs,The MIT License,0,0,3,0,2024-07-22
gcui-art/album-ai,https://github.com/gcui-art/album-ai,754,AI-First Album: Chat with your gallery using plain language! LLM Vision + RAG + Album/Gallery.,Apache License 2.0,0,0,3,0,2024-07-19
withastro/storefront,https://github.com/withastro/storefront,668,Astro for ecommerce üí∞,The MIT License,0,0,3,0,2024-09-20
TahaSh/blendy,https://github.com/TahaSh/blendy,540,üßà Smoothly transition one element into another with just a few lines of code.,The MIT License,0,0,3,0,2024-12-17
liumengniu/majiang,https://github.com/liumengniu/majiang,532,laya3.xÂºïÊìé + nodejs ÂºÄÂèëÁöÑÁΩëÁªúÈ∫ªÂ∞ÜÔºåÁúÅÂéª‰∫ÜÂ§ßÈáèÂ§çÊùÇÈÖçÁΩÆÔºåÊûÅÂÖ∂ÈÄÇÂêà‰∏äÊâã,The MIT License,0,0,3,0,2024-09-14
upstash/wikipedia-semantic-search,https://github.com/upstash/wikipedia-semantic-search,448,Semantic Search on Wikipedia with Upstash Vector,The MIT License,0,0,3,0,2024-07-26
cjinhuo/text-search-engine,https://github.com/cjinhuo/text-search-engine,441,A text search engine that supports mixed Chinese and English fuzzy search.,The MIT License,0,0,3,0,2024-08-08
YOYZHANG/PodCastLM,https://github.com/YOYZHANG/PodCastLM,406,PDF ÁîüÊàê‰∏≠ÊñáÊí≠ÂÆ¢,The MIT License,0,0,3,0,2024-10-10
BandarLabs/gitpodcast,https://github.com/BandarLabs/gitpodcast,389,Convert any git repository into an engaging podcast,The MIT License,0,0,3,0,2024-12-31
frostming/fxzhihu,https://github.com/frostming/fxzhihu,387,‰∏∫Áü•‰πéÁîüÊàêÂèØÂàÜ‰∫´ÁöÑÂç°ÁâáÂèä Instant View,The MIT License,0,0,3,0,2024-09-25
xiaoxiunique/x-kit,https://github.com/xiaoxiunique/x-kit,370,‰∏Ä‰∏™Áî®‰∫éÊäìÂèñÂíåÂàÜÊûê X (Twitter) Áî®Êà∑Êï∞ÊçÆÂíåÊé®ÊñáÁöÑÂ∑•ÂÖ∑„ÄÇ,The MIT License,0,0,3,0,2024-12-16
antfu/are-we-esm,https://github.com/antfu/are-we-esm,341,Are we fully ESM yet?,The MIT License,0,0,3,0,2025-01-15
tilyupo/qustar,https://github.com/tilyupo/qustar,318,Query SQL database through an array-like API,The MIT License,0,0,3,0,2024-07-16
sdan/r1-web,https://github.com/sdan/r1-web,300,deepseek running locally in your browser,The MIT License,0,0,3,0,2025-01-29
13point5/gemini-cursor,https://github.com/13point5/gemini-cursor,294,An AI cursor for desktop using Gemini 2.0 Flash (Experimental),The MIT License,0,0,3,0,2025-02-10
muneebhashone/typescript-backend-toolkit,https://github.com/muneebhashone/typescript-backend-toolkit,286,"TypeScript Backend Toolkit - Express.js - Swagger (OpenAPI 3.0) Autogenered docs, Zod - BullMQ - React Email - Mailgun - Docker - MongoDB (Mongoose) - Socket.io",The MIT License,0,0,3,0,2024-08-11
ChainBuff/sol-arb-bot,https://github.com/ChainBuff/sol-arb-bot,281,a solana dex arbitrage bot based on Jupiter v6,The MIT License,0,0,3,0,2024-11-17
rajnandan1/termo,https://github.com/rajnandan1/termo,250,Termo is a simple terminal emulator for the browser. It is a wrapper on top of xterm,The MIT License,0,0,3,0,2024-12-05
vercel-labs/ai-sdk-preview-rag,https://github.com/vercel-labs/ai-sdk-preview-rag,221,,The MIT License,0,0,3,0,2024-07-10
DiscovAI/DiscovAI-search,https://github.com/DiscovAI/DiscovAI-search,218,"üîç DiscovAI-Search: An AI-powered search engine for AI tools and custom data. Built with Next.js, OpenAI, Supabase, and more. Features vector-based search, Redis caching, and LLM-powered responses.",Apache License 2.0,0,0,3,0,2024-07-30
0xthierry/llama-parse-cli,https://github.com/0xthierry/llama-parse-cli,212,A non-official CLI for Llama Index Parser,The MIT License,0,0,3,0,2024-07-08
punkpeye/fastmcp,https://github.com/punkpeye/fastmcp,205,A TypeScript framework for building MCP servers.,The MIT License,0,0,3,0,2024-12-27
laiso/site2pdf,https://github.com/laiso/site2pdf,194,"Generate comprehensive PDFs of entire websites, ideal for RAG.",The MIT License,0,0,3,0,2024-07-14
13point5/open-artifacts,https://github.com/13point5/open-artifacts,177,ü¶â Open Source clone of Claude.ai that can generate Artifacts,The MIT License,0,0,3,0,2024-07-14
moeru-ai/xsai,https://github.com/moeru-ai/xsai,175,"ü§ñüí¨ extra-small AI SDK for Browser, Node.js, Deno, Bun or Edge Runtime.",The MIT License,0,0,3,0,2024-11-21
dockur/umbrel,https://github.com/dockur/umbrel,175,umbrelOS inside a Docker container.,The MIT License,0,0,3,0,2024-09-23
metaspartan/curiso,https://github.com/metaspartan/curiso,165,Curiso is an infinite canvas for your thoughts,The MIT License,0,0,3,0,2025-01-02
addyosmani/say,https://github.com/addyosmani/say,157,Say - A Whisper AI Notes app,The MIT License,0,0,3,0,2024-10-17
maru-re/maru,https://github.com/maru-re/maru,157,„ÄåÂî±Ê≠åÂ≠∏Êó•Êñá„Äç - Âü∫Êñº YouTube ÁöÑÊ≠åÊõ≤Ê≠åË©ûÈñ±ËÆÄÂô®,The MIT License,0,0,3,0,2024-09-29
antfu/vscode-pnpm-catalog-lens,https://github.com/antfu/vscode-pnpm-catalog-lens,148,Show versions inline for PNPM catalog: field,The MIT License,0,0,3,0,2024-08-21
subframe7536/vscode-custom-ui-style,https://github.com/subframe7536/vscode-custom-ui-style,148,"VSCode extension that modify CSS and JS code in both editor and webview, unify global font family, setup background image and Electron BrowserWindow options, or add your custom CSS or JS code",The MIT License,0,0,3,0,2024-10-12
Peiiii/AgentVerse,https://github.com/Peiiii/AgentVerse,148,Multi-Agent Collaboration  Platform‚ú®,The MIT License,0,0,3,0,2025-02-06
wevm/ox,https://github.com/wevm/ox,140,Standard Library for Ethereum,The MIT License,0,0,3,0,2024-08-13
s00d/nuxt-i18n-micro,https://github.com/s00d/nuxt-i18n-micro,140,"Nuxt I18n Micro is a fast, simple, and lightweight internationalization (i18n) module for Nuxt",The MIT License,0,0,3,0,2024-08-15
mimalef70/CodeTree,https://github.com/mimalef70/CodeTree,130,"üå≥ Transform your codebase into AI-ready insights! Smart CLI tool for seamless code analysis with ChatGPT, Claude & Gemini.",The MIT License,0,0,3,0,2024-11-13
vratix-dev/api-library,https://github.com/vratix-dev/api-library,118,Easy to use Open Source modules that implement common API logic and can be used in your Node.js backend services,The MIT License,0,0,3,0,2024-09-30
jasonjmcghee/claude-debugs-for-you,https://github.com/jasonjmcghee/claude-debugs-for-you,115,Enable any LLM (e.g. Claude) to interactively debug any language for you via MCP and a VS Code Extension,The MIT License,0,0,3,0,2025-01-17
shadcn-ui/registry-template,https://github.com/shadcn-ui/registry-template,114,A template for running your own registry.,The MIT License,0,0,3,0,2025-01-16
axar-ai/axar,https://github.com/axar-ai/axar,107,Minimal typescript agent framework that keeps it simple and gives you control - no BS,Apache License 2.0,0,0,3,0,2025-01-04
kennethnym/doors-wallpaper,https://github.com/kennethnym/doors-wallpaper,104,"a free open source, no tracking alternative to panels.art",Apache License 2.0,0,0,3,0,2024-09-24
btahir/next-beats,https://github.com/btahir/next-beats,104," A modern, open-source lofi experience powered by Next.js",The MIT License,0,0,3,0,2024-11-17
etkecc/synapse-admin,https://github.com/etkecc/synapse-admin,100,"A maintained fork of the admin console for (Matrix) Synapse homeservers, including additional features",Apache License 2.0,0,0,3,0,2024-08-27
PySpur-Dev/pyspur,https://github.com/PySpur-Dev/pyspur,1488,Graph UI for AI Agents in Python,Apache License 2.0,0,0,2,0,2024-09-23
ui-layouts/uilayouts,https://github.com/ui-layouts/uilayouts,1433,"üî•100+ Free beautifull interactive react/nextjs component based on tailwindcss, framer-motion, gsap etc",The MIT License,0,0,2,0,2024-08-11
internet-development/www-sacred,https://github.com/internet-development/www-sacred,1112,"SRCL is an open-source React component and style repository that helps you build web applications, desktop applications, and static websites with terminal aesthetics.",The MIT License,0,0,2,0,2024-11-14
tonghohin/screen-sharing,https://github.com/tonghohin/screen-sharing,1013,Share your screen with one simple room code. No downloads or sign-ups required.,The MIT License,0,0,2,0,2024-11-04
lukeed/tschema,https://github.com/lukeed/tschema,722,A tiny (500b) utility to build JSON schema types.,The MIT License,0,0,2,0,2024-07-22
bloomberg/ts-blank-space,https://github.com/bloomberg/ts-blank-space,671,"A small, fast, pure JavaScript type-stripper that uses the official TypeScript parser.",Apache License 2.0,0,0,2,0,2024-08-19
kokonut-labs/kokonutui,https://github.com/kokonut-labs/kokonutui,553,Collection of components built for Next.js and React with Tailwind CSS and shadcn/ui,The MIT License,0,0,2,0,2024-11-01
selemondev/spark-ui,https://github.com/selemondev/spark-ui,547,"Experience The Magic Of Animated Components. Crafted With Vue, TypeScript, TailwindCss And Vueuse Motion ‚ú®",The MIT License,0,0,2,0,2024-09-28
aotakeda/learn-thing,https://github.com/aotakeda/learn-thing,536,Create mind maps to learn new things using AI.,The MIT License,0,0,2,0,2024-10-16
khromov/ai-digest,https://github.com/khromov/ai-digest,448,A CLI tool to aggregate your codebase into a single Markdown file for use with Claude Projects or custom ChatGPTs.,The MIT License,0,0,2,0,2024-07-15
arturbien/balloons-js,https://github.com/arturbien/balloons-js,392,üéà Animated balloons effect for your website,The MIT License,0,0,2,0,2024-08-24
askaitools/askaitools-community-edition,https://github.com/askaitools/askaitools-community-edition,346,A cutting-edge search engine project tailored specifically for the AI product,Apache License 2.0,0,0,2,0,2024-07-11
zcaceres/markdownify-mcp,https://github.com/zcaceres/markdownify-mcp,301,A Model Context Protocol server for converting almost anything to Markdown,The MIT License,0,0,2,0,2024-12-18
mislam/typezero,https://github.com/mislam/typezero,295,"Zero-config TypeScript starter for modern Node.js development. ESM, Vitest, ESLint, Prettier. Production-ready in seconds! ‚ö°",The MIT License,0,0,2,0,2025-01-29
noworneverev/graphrag-visualizer,https://github.com/noworneverev/graphrag-visualizer,283,A web-based tool for visualizing and exploring artifacts from Microsoft's GraphRAG.,The MIT License,0,0,2,0,2024-08-06
mickasmt/next-auth-roles-template,https://github.com/mickasmt/next-auth-roles-template,281,"Open-source Nextjs 14 Template Starter with Auth.js v5, User Roles & Admin Panel. Remove blog or docs parts with one cli.",The MIT License,0,0,2,0,2024-07-05
seadfeng/favicon-downloader,https://github.com/seadfeng/favicon-downloader,247,,The MIT License,0,0,2,0,2024-08-20
bytefer/ollama-ocr,https://github.com/bytefer/ollama-ocr,236,Implementing OCR with a local visual model run by ollama.,The MIT License,0,0,2,0,2024-11-25
hrishioa/mandark,https://github.com/hrishioa/mandark,234,"Simple AI coder that can do most of my work for me, including working on himself.",Apache License 2.0,0,0,2,0,2024-07-20
raphaelsalaja/toldo,https://github.com/raphaelsalaja/toldo,222,An elevated dialog component for React.,The MIT License,0,0,2,0,2024-10-19
openai/openai-realtime-twilio-demo,https://github.com/openai/openai-realtime-twilio-demo,205,,The MIT License,0,0,2,0,2024-12-16
burakorkmez/code-craft,https://github.com/burakorkmez/code-craft,204,Build a Code Editor SaaS with Next.js 15,The MIT License,0,0,2,0,2024-12-08
ithacaxyz/porto,https://github.com/ithacaxyz/porto,198,Experimental Next-gen Account,Apache License 2.0,0,0,2,0,2024-11-12
Arindam200/logo-ai,https://github.com/Arindam200/logo-ai,195,AI Powered Logo Generator | Powered by Nebius AI,The MIT License,0,0,2,0,2025-01-16
agentlabs-dev/auto-inspector,https://github.com/agentlabs-dev/auto-inspector,177,"Web Testing AI Agent - Write your specs, it does the rest",Apache License 2.0,0,0,2,0,2025-02-04
rudrodip/asyncr,https://github.com/rudrodip/asyncr,175,Async Select component built with React & ShadCN UI,The MIT License,0,0,2,0,2024-12-24
ChainBuff/yellowstone-grpc,https://github.com/ChainBuff/yellowstone-grpc,171,ÂèØÂø´ÈÄü‰∏äÊâãÁöÑ Yellowstone gRPC ÊïôÁ®ã,The MIT License,0,0,2,0,2024-12-29
Rabnail-SOL/Solana-PumpFun-Bundler,https://github.com/Rabnail-SOL/Solana-PumpFun-Bundler,169,Pumpfun bundler with 20 wallets that creates pool in pumpfun and bundle buy with 20 wallets using jito bundle,The MIT License,0,0,2,0,2024-11-07
mckaywrigley/ai-router-chat,https://github.com/mckaywrigley/ai-router-chat,168,,The MIT License,0,0,2,0,2024-07-31
unternet-co/web-applets,https://github.com/unternet-co/web-applets,164,"The home of the Web Applets spec, demo and SDK",The MIT License,0,0,2,0,2024-09-20
pydantic/pydantic.run,https://github.com/pydantic/pydantic.run,146,Python browser sandbox.,The MIT License,0,0,2,0,2025-01-17
ankitpathak62/3D_Portfolio,https://github.com/ankitpathak62/3D_Portfolio,142,,The MIT License,0,0,2,0,2025-01-18
colanode/colanode,https://github.com/colanode/colanode,140,Open-source and local-first Slack and Notion alternative that puts you in control of your data,Apache License 2.0,0,0,2,0,2024-07-29
JiuRanYa/IconEase,https://github.com/JiuRanYa/IconEase,138,Modern desktop application for efficient icon collection management and organization.,The MIT License,0,0,2,0,2024-10-30
LangGraph-GUI/LangGraph-GUI,https://github.com/LangGraph-GUI/LangGraph-GUI,134,Visual node-edge graph GUI editor for LangGraph and run with local LLM or online API,The MIT License,0,0,2,0,2024-07-17
YOYZHANG/ai-ppt,https://github.com/YOYZHANG/ai-ppt,131,Generated ppt by AI based on RevealJS synax,The MIT License,0,0,2,0,2024-09-19
xavia-io/xavia-ota,https://github.com/xavia-io/xavia-ota,130,A self-hosted Over-The-Air (OTA) updates server for Expo/RN applications that gives you complete control over your app's update distribution. ,The MIT License,0,0,2,0,2024-11-20
Y80/bmm,https://github.com/Y80/bmm,128,BMMÔºå‰Ω†ÁöÑ‰∏ìÂ±û‰π¶Á≠æÁÆ°ÂÆ∂ ü§µ,The MIT License,0,0,2,0,2024-09-13
burakorkmez/nextjs-course,https://github.com/burakorkmez/nextjs-course,126,NextJS Tutorial by Building a Social Media App,The MIT License,0,0,2,0,2024-12-30
fal3n-4ngel/SOYO,https://github.com/fal3n-4ngel/SOYO,124,SOYO - Stream Own Your Own || Effortlessly stream files from your local system via local network and enjoy your personal collection anywhere in your home.,The MIT License,0,0,2,0,2024-10-20
xNomad-AI/core,https://github.com/xNomad-AI/core,123,"The core service to index, operate and interact with AI-NFT.",The MIT License,0,0,2,0,2024-12-28
hamzasaleem2/sticky,https://github.com/hamzasaleem2/sticky,121,"Organize thoughts, collaborate in real-time, and access your ideas from anywhere. Try it free today!",The MIT License,0,0,2,0,2024-10-09
Shreyas-29/luro-ai,https://github.com/Shreyas-29/luro-ai,114,A Modern UI Website for your next generation SaaS,The MIT License,0,0,2,0,2024-08-24
playcanvas/react,https://github.com/playcanvas/react,112,Build 3D apps with React,The MIT License,0,0,2,0,2024-10-11
realworld-angular/realworld-angular,https://github.com/realworld-angular/realworld-angular,109,RealWorld Angular examples apps showcasing Angular libraries in action,Apache License 2.0,0,0,2,0,2024-07-14
andytyler/playwright-ai,https://github.com/andytyler/playwright-ai,108,,The MIT License,0,0,2,0,2024-11-09
get-convex/convex-saas,https://github.com/get-convex/convex-saas,103,"A production-ready Convex Stack for your next SaaS application with Convex Auth, Stripe, TanStack, Resend, Tailwindcss, and shadcn.",The MIT License,0,0,2,0,2024-07-27
fiston-user/contract-analysis-yt,https://github.com/fiston-user/contract-analysis-yt,99,"AI-powered platform that helps streamline contract analysis. It quickly identifies risks, enhances compliance, and offers insights for faster negotiations. By automating these processes, it significantly reduces legal costs and accelerates contract reviews, allowing businesses to manage contracts more efficiently.",The MIT License,0,0,2,0,2024-10-08
toss/frontend-fundamentals,https://github.com/toss/frontend-fundamentals,1177,Guidelines for easily modifiable frontend code,The MIT License,0,0,1,0,2024-12-18
iAmCorey/awesome-indie-hacker-tools,https://github.com/iAmCorey/awesome-indie-hacker-tools,935,Áã¨Á´ãÂºÄÂèë/Âá∫Êµ∑ÂºÄÂèëÁõ∏ÂÖ≥ÊäÄÊúØÊ†àÂèäÂ∑•ÂÖ∑Êî∂ÂΩï / Find the best tools for indie hackers here,The MIT License,0,0,1,0,2024-09-30
Scthe/nanite-webgpu,https://github.com/Scthe/nanite-webgpu,800,"UE5's Nanite implementation using WebGPU. Includes the meshlet LOD hierarchy, software rasterizer and billboard impostors. Culling on both per-instance and per-meshlet basis.",The MIT License,0,0,1,0,2024-07-15
FormBee/FormBee,https://github.com/FormBee/FormBee,675,The open-source form backend for data privacy conscious developers.,The MIT License,0,0,1,0,2024-07-16
EarthZetaOrg/solana-copytrade-bot,https://github.com/EarthZetaOrg/solana-copytrade-bot,662,"‚ú®‚ú®‚ú® Solana CopyTrading Bot is a copytrading automation bot designed to mirror the copytrading strategies of successful or selected traders wallet on Solana. Excutes the same trades in real-time on the user's behalf for copytrading bot, pumpfun copy trading bot, raydium copy trading bot, meteora copy trading bot, jupiter copy trading bot",The MIT License,0,0,1,0,2024-11-29
Idee8/ShipFree,https://github.com/Idee8/ShipFree,617,Open Source Next.js Saas Boilerplate Alternative to ShipFast,The MIT License,0,0,1,0,2025-02-01
SouthBridgeAI/offmute,https://github.com/SouthBridgeAI/offmute,453,An experiment in meeting transcription and diarization with just an LLM. Maybe I went a little overboard though,Apache License 2.0,0,0,1,0,2024-10-30
AndySpider/uicloner-extension,https://github.com/AndySpider/uicloner-extension,422,"Browser extension to instantly clone any web UI you see with one click, exports to HTML + Tailwind CSS or HTML + pure CSS",The MIT License,0,0,1,0,2024-11-19
misbahsy/meetingmind,https://github.com/misbahsy/meetingmind,417,"AI Meeting Minutes analysis App built with NextJS, Langflow, Groq, and OpenAI",The MIT License,0,0,1,0,2024-10-06
adaline/gateway,https://github.com/adaline/gateway,414,"The only fully local production-grade Super SDK that provides a simple, unified, and powerful interface for calling more than 200+ LLMs.",The MIT License,0,0,1,0,2024-10-15
chclt/oh-my-wechat,https://github.com/chclt/oh-my-wechat,389,ÂæÆ‰ø°Â§á‰ªΩ‰∏éÊï∞ÊçÆÊä•Âëä,The MIT License,0,0,1,0,2024-10-28
bramus/style-observer,https://github.com/bramus/style-observer,387,MutationObserver for CSS. Get notified when the computed value of a CSS property changes.,The MIT License,0,0,1,0,2024-08-29
ObservedObserver/convertfast-ui,https://github.com/ObservedObserver/convertfast-ui,365,Build beautiful landing pages with prebuild code blocks. All based on shadcn-ui and tailwind.,The MIT License,0,0,1,0,2024-07-10
Softlandia-Ltd/vision-is-all-you-need,https://github.com/Softlandia-Ltd/vision-is-all-you-need,343,Serverless Modal + FastAPI + React + ColPali + Qdrant + GPT4o Vision RAG (V-RAG) Demo,The MIT License,0,0,1,0,2024-09-10
all-in-aigc/pagen-ai-landing-page-template,https://github.com/all-in-aigc/pagen-ai-landing-page-template,334,AI Landing Page Template created by Pagen AI,The MIT License,0,0,1,0,2024-09-12
taishikato/supavec,https://github.com/taishikato/supavec,320,"The open-source alternative to Carbon.ai. Build powerful RAG applications with any data source, at any scale.",Apache License 2.0,0,0,1,0,2024-12-24
eyelly-wu/appstore-discounts,https://github.com/eyelly-wu/appstore-discounts,301,"An open-source App Store discounts tracker built on GitHub Actions, supporting RSS, Telegram and DingTalk notifications",The MIT License,0,0,1,0,2024-07-19
joschan21/pingpanda,https://github.com/joschan21/pingpanda,297,A Modern Fullstack Event Monitoring SaaS,The MIT License,0,0,1,0,2024-10-31
claudio-silva/claude-artifact-runner,https://github.com/claudio-silva/claude-artifact-runner,288,"A template project for easily converting Claude AI‚Äôs Artifacts into React applications, ready to run out of the box or extend as needed.",The MIT License,0,0,1,0,2024-07-14
WebDevSimplified/permission-system,https://github.com/WebDevSimplified/permission-system,283,,The MIT License,0,0,1,0,2024-10-28
stripe/agent-toolkit,https://github.com/stripe/agent-toolkit,272,Python and TypeScript library for integrating the Stripe API into agentic workflows,The MIT License,0,0,1,0,2024-11-11
antoineross/Hikari,https://github.com/antoineross/Hikari,271,"A complete & open source Nextjs.14, Stripe and Supabase SaaS Starter Template using App Router",The MIT License,0,0,1,0,2024-07-23
nainglinnkhant/shadcn-view-table,https://github.com/nainglinnkhant/shadcn-view-table,266,"Shadcn table component with server side sorting, pagination, filtering, and custom views. This is built on top of @sadmann17's shadcn-table.",The MIT License,0,0,1,0,2024-07-03
ViggoZ/json-translate,https://github.com/ViggoZ/json-translate,255,,The MIT License,0,0,1,0,2024-11-12
CassInfra/KubeDoor,https://github.com/CassInfra/KubeDoor,245,Âü∫‰∫éAIÊé®Ëçê+‰∏ìÂÆ∂ÁªèÈ™åÁöÑK8SË¥üËΩΩÊÑüÁü•Ë∞ÉÂ∫¶‰∏éÂÆπÈáèÁÆ°ÊéßÁ≥ªÁªü,Apache License 2.0,0,0,1,0,2024-12-01
upstash/rag-chat-component,https://github.com/upstash/rag-chat-component,241,React component for RAG-enabled AI Assistant,The MIT License,0,0,1,0,2024-08-28
regenrek/codefetch,https://github.com/regenrek/codefetch,239,Turn code into Markdown for LLMs with one simple terminal command,The MIT License,0,0,1,0,2025-01-11
sarimabbas/authortrail,https://github.com/sarimabbas/authortrail,230,See all the files you have ever touched in a Git repo,The MIT License,0,0,1,0,2024-12-22
aiagentdev-sol/pumpfun-bundler-bot,https://github.com/aiagentdev-sol/pumpfun-bundler-bot,217,"PumpFun bundler bot, create/buy token in single bundle for Pumpfun",The MIT License,0,0,1,0,2025-01-31
arc53/llm-price-compass,https://github.com/arc53/llm-price-compass,217,"This project collects GPU benchmarks from various cloud providers and compares them to fixed per token costs. Use our tool for efficient LLM GPU selections and cost-effective AI models. LLM provider price comparison, gpu benchmarks to price per token calculation, gpu benchmark table",The MIT License,0,0,1,0,2024-08-12
bklieger-groq/mathtutor-on-groq,https://github.com/bklieger-groq/mathtutor-on-groq,215,Voice-Enabled Math Tutor Powered by Groq that Calculates and Renders Live Problems and Instruction with LaTeX in Seconds!,Apache License 2.0,0,0,1,0,2024-12-18
morris/vanilla-prime,https://github.com/morris/vanilla-prime,211,"A simpler, more sustainable way of web development",ISC License,0,0,1,0,2024-07-31
run-llama/chat-ui,https://github.com/run-llama/chat-ui,200,Chat UI components for LLM apps,The MIT License,0,0,1,0,2024-10-18
FadyMak/imgsrc-app,https://github.com/FadyMak/imgsrc-app,193,Generate beautiful Open Graph images,The MIT License,0,0,1,0,2024-12-20
w4n9hu1/hot-hub-web,https://github.com/w4n9hu1/hot-hub-web,191,üìàÂÆûÊó∂ËøΩË∏™ÁÉ≠ÁÇπËØùÈ¢òÔºå‰∏ÄÁ´ôÂºèÊü•Áúã‰∏éÊêúÁ¥¢„ÄÇ,The MIT License,0,0,1,0,2024-09-28
sadmann7/diceui,https://github.com/sadmann7/diceui,187,Unstyled ui component library.,The MIT License,0,0,1,0,2024-11-23
EDEAI/NexusAI,https://github.com/EDEAI/NexusAI,184,,Apache License 2.0,0,0,1,0,2024-11-26
mckaywrigley/r1-automated-pr-example,https://github.com/mckaywrigley/r1-automated-pr-example,179,,The MIT License,0,0,1,0,2025-01-27
notAkki/spots,https://github.com/notAkki/spots,178,,The MIT License,0,0,1,0,2024-09-21
kleneway/awesome-cursor-mpc-server,https://github.com/kleneway/awesome-cursor-mpc-server,169,Example of an MCP server with custom tools that can be called directly from cursor,The MIT License,0,0,1,0,2025-02-05
ilyichv/shadcn-zod-form,https://github.com/ilyichv/shadcn-zod-form,168,CLI tool to convert Zod schemas into shadcn/ui forms.,The MIT License,0,0,1,0,2024-09-09
scriptkavi/hooks,https://github.com/scriptkavi/hooks,158,Empower your react project with accessible and customizable hooks. Copy paste the modern hooks and use them in your React or NextJS applications.,The MIT License,0,0,1,0,2024-07-18
aws-samples/swift-chat,https://github.com/aws-samples/swift-chat,156,A Cross-platform AI chat application built with React Native and powered by Amazon Bedrock,MIT No Attribution,0,0,1,0,2024-11-06
enzomanuelmangano/pressto,https://github.com/enzomanuelmangano/pressto,152,Your React Native app deserves better tapping interactions.,The MIT License,0,0,1,0,2024-09-17
sjml/wasmbots,https://github.com/sjml/wasmbots,151,wasm. bots. ü§ñüßô‚Äç‚ôÇÔ∏èüßöüßô‚Äç‚ôÄÔ∏è‚öîÔ∏èüè∞ü§ñ,The MIT License,0,0,1,0,2024-10-03
diandian18/react-antd-console,https://github.com/diandian18/react-antd-console,148,Customizable admin dashboard template based on React 18+ and Ant Design 5+,The MIT License,0,0,1,0,2024-10-14
haydenbleasel/dialog-stack,https://github.com/haydenbleasel/dialog-stack,143,Composable stacked dialogs for shadcn/ui,The MIT License,0,0,1,0,2024-11-28
ruvnet/SynthLang,https://github.com/ruvnet/SynthLang,142,SynthLang is a hyper-efficient prompt language designed to optimize interactions with Large Language Models (LLMs) like GPT-4o by leveraging logographical scripts and symbolic constructs.,The MIT License,0,0,1,0,2025-01-05
luoling8192/telegram-search,https://github.com/luoling8192/telegram-search,142,‰∏Ä‰∏™ÂäüËÉΩÂº∫Â§ßÁöÑ Telegram ËÅäÂ§©ËÆ∞ÂΩïÊêúÁ¥¢Â∑•ÂÖ∑ÔºåÊîØÊåÅÂêëÈáèÊêúÁ¥¢ÂíåËØ≠‰πâÂåπÈÖç„ÄÇ,The MIT License,0,0,1,0,2025-02-08
tovacinni/research-website-template,https://github.com/tovacinni/research-website-template,139,"React + Next.js template for research websites (for PhD students, researchers, etc)",The MIT License,0,0,1,0,2025-01-04
oslo-project/jwt,https://github.com/oslo-project/jwt,137,Parse and encode JSON web tokens,The MIT License,0,0,1,0,2024-09-16
yjose/input-otp-native,https://github.com/yjose/input-otp-native,134,"üîê OTP input for React Native/Expo App: unstyled, copy-paste examples, fully tested",The MIT License,0,0,1,0,2024-12-20
prismicio-community/course-fizzi-next,https://github.com/prismicio-community/course-fizzi-next,134,,Apache License 2.0,0,0,1,0,2024-08-27
cloudflare/openai-workers-relay,https://github.com/cloudflare/openai-workers-relay,127,"A relay server for OpenAI's realtime API, for Cloudflare Workers",The MIT License,0,0,1,0,2024-10-19
launch-ui/launch-ui,https://github.com/launch-ui/launch-ui,125,"Landing page kit built with React, Shadcn/ui and Tailwind that you can copy/paste into your project.",The MIT License,0,0,1,0,2024-10-04
ValueMelody/melody-auth,https://github.com/ValueMelody/melody-auth,122,"A turnkey OAuth & authentication system, designed for both Cloudflare Workers and Node.js",The MIT License,0,0,1,0,2024-07-09
yeldarby/nycerebro,https://github.com/yeldarby/nycerebro,122,,Apache License 2.0,0,0,1,0,2025-01-17
e2b-dev/ai-analyst,https://github.com/e2b-dev/ai-analyst,114,Open source AI analyst powered by E2B. Analyze your CSV files with Llama 3.1 and create interactive charts.,Apache License 2.0,0,0,1,0,2024-10-21
aitmiloud/zellige,https://github.com/aitmiloud/zellige,114,"A Moroccan utility library for working with CIN, phone numbers, currency, addresses, dates, and more.",The MIT License,0,0,1,0,2025-02-12
dupontgu/now-playing-bumper-sticker,https://github.com/dupontgu/now-playing-bumper-sticker,110,"A ""bumper sticker"" (LCD display) that shows what I am listening to on Spotify in near real-time",The MIT License,0,0,1,0,2024-09-04
dabit3/ai-agent-cognitivedriftt,https://github.com/dabit3/ai-agent-cognitivedriftt,110,Cognitive Drift AI Agent,The MIT License,0,0,1,0,2024-12-03
microsoft/TypeAgent,https://github.com/microsoft/TypeAgent,110,Sample code that explores an architecture for using TypeChat to build a personal agent that can work with application agents.,The MIT License,0,0,1,0,2024-07-16
privatenumber/dtsroll,https://github.com/privatenumber/dtsroll,109,TypeScript declaration (.d.ts) bundler,The MIT License,0,0,1,0,2025-01-05
tyrellshawn/bolt.diy,https://github.com/tyrellshawn/bolt.diy,109,Bolt DIY,The MIT License,0,0,1,0,2024-12-12
seadfeng/redirect-checker,https://github.com/seadfeng/redirect-checker,107,,The MIT License,0,0,1,0,2024-08-13
jakearchibald/stacked-alpha-video,https://github.com/jakearchibald/stacked-alpha-video,106,,Apache License 2.0,0,0,1,0,2024-07-23
volume988/flux-ai-image-webui,https://github.com/volume988/flux-ai-image-webui,103,flux ai image generator web ui,The MIT License,0,0,1,0,2024-08-19
wong2/litemcp,https://github.com/wong2/litemcp,103,A TypeScript framework for building MCP servers elegantly,The MIT License,0,0,1,0,2024-12-09
stack-auth/multi-tenant-starter-template,https://github.com/stack-auth/multi-tenant-starter-template,101,A minimalistic multi-tenant Next.js starter template,The MIT License,0,0,1,0,2024-08-19
clerk/og.new,https://github.com/clerk/og.new,100,,The MIT License,0,0,1,0,2024-12-21
tsoding/multiplayer-game-prototype,https://github.com/tsoding/multiplayer-game-prototype,97,Proof-of-concept of a Simple Multiplayer Game,The MIT License,0,0,1,0,2024-07-12
openai/openai-structured-outputs-samples,https://github.com/openai/openai-structured-outputs-samples,601,Sample apps to help developers get started with Structured Outputs,The MIT License,0,0,0,0,2024-12-16
EarthZetaOrg/solana-raydium-bundler,https://github.com/EarthZetaOrg/solana-raydium-bundler,574,‚ú®‚ú®‚ú® Solana Raydium Bundler with 21 wallets simultaneously bundling to buy for pool creation using Jito for raydium bundler,The MIT License,0,0,0,0,2024-11-29
oiov/wr.do,https://github.com/oiov/wr.do,545,"üéâFree domain name distribution and short url generation platform, build with cloudflare.",The MIT License,0,0,0,0,2024-07-26
shelwinsunga/zoom-chart-demo,https://github.com/shelwinsunga/zoom-chart-demo,513,A zoomable shadcn/rechart chart.,The MIT License,0,0,0,0,2024-07-13
rocicorp/hello-zero,https://github.com/rocicorp/hello-zero,482,,Apache License 2.0,0,0,0,0,2024-10-11
groq/groq-appgen,https://github.com/groq/groq-appgen,447,Project showcasing Llama 3.3 70B HTML codegen abilities,The MIT License,0,0,0,0,2024-12-17
NiazMorshed2007/shadcn-tiptap,https://github.com/NiazMorshed2007/shadcn-tiptap,444,Sets of custom extensions & toolbars for tiptap editor. Install with shadcn/cli.,The MIT License,0,0,0,0,2024-10-17
Dhravya/backend-api-kit,https://github.com/Dhravya/backend-api-kit,410,"Easily create scalable, monetisable backend APIs with Hono + Cloudflare workers. All the batteries included.",The MIT License,0,0,0,0,2025-01-24
WenJing95/SayKey,https://github.com/WenJing95/SayKey,395,A Speech-to-Text Input Method For Windows,The MIT License,0,0,0,0,2024-10-16
openai/openai-realtime-solar-system,https://github.com/openai/openai-realtime-solar-system,357,Demo showing how to use the OpenAI Realtime API to navigate a 3D scene via tool calling,The MIT License,0,0,0,0,2025-01-13
EarthZetaOrg/solana-pumpfun-bundler,https://github.com/EarthZetaOrg/solana-pumpfun-bundler,353,‚ú®‚ú®‚ú® Solana Pumpfun Bundler with 24 wallets that create/buy token and pool in single bundler using jito for pumpfun,The MIT License,0,0,0,0,2024-11-29
mjackson/multipart-parser,https://github.com/mjackson/multipart-parser,352,"A fast, efficient parser for multipart streams in any JavaScript environment",The MIT License,0,0,0,0,2024-07-11
iAmCorey/coreychiu-portfolio-template,https://github.com/iAmCorey/coreychiu-portfolio-template,315,portfolio template by corey chiu,The MIT License,0,0,0,0,2024-12-11
tremorlabs/tremor-blocks,https://github.com/tremorlabs/tremor-blocks,304,Tremor Blocks Source Code,The MIT License,0,0,0,0,2025-01-22
martiserra99/formity,https://github.com/martiserra99/formity,288,Formity - A highly customizable React library for creating advanced multi-step forms (https://www.formity.app/).,The MIT License,0,0,0,0,2024-08-02
rajibola/human-regex,https://github.com/rajibola/human-regex,272,Human-friendly regular expression builder with English-like syntax.,The MIT License,0,0,0,0,2025-01-31
iAmCorey/devtoolset,https://github.com/iAmCorey/devtoolset,261,Open-source & database-free & server-free developer tools navigator / Êó†ÈúÄÊï∞ÊçÆÂ∫ìÊó†ÈúÄÊúçÂä°Âô®ÁöÑÂºÄÊ∫êÂºÄÂèëËÄÖÂ∑•ÂÖ∑ÂØºËà™Á´ô,The MIT License,0,0,0,0,2024-08-14
coryhouse/react-switchboard,https://github.com/coryhouse/react-switchboard,260,Quickly create custom DevTools for your React app,The MIT License,0,0,0,0,2024-07-28
lukeed/empathic,https://github.com/lukeed/empathic,250,A set of small Node.js utilities to understand your pathing needs.,The MIT License,0,0,0,0,2024-09-01
PuruVJ/neotraverse,https://github.com/PuruVJ/neotraverse,235,,The MIT License,0,0,0,0,2024-07-10
nainglinnkhant/lingua-time,https://github.com/nainglinnkhant/lingua-time,234,A smart datetime picker which understands natural language input.,The MIT License,0,0,0,0,2024-09-03
CNTRLAI/Notate,https://github.com/CNTRLAI/Notate,231,"Notate is a desktop chat application that takes AI conversations to the next level. It combines the simplicity of chat with advanced features like document analysis, vector search, and multi-model AI support - all while keeping your data private.",Apache License 2.0,0,0,0,0,2025-01-07
azat-io/eslint-plugin-de-morgan,https://github.com/azat-io/eslint-plugin-de-morgan,229,üßµ ESLint plugin for transforming negated boolean expressions via De¬†Morgan‚Äôs laws,The MIT License,0,0,0,0,2025-02-09
taishikato/chatsage,https://github.com/taishikato/chatsage,228,24/7 Customer Service for your website,Apache License 2.0,0,0,0,0,2024-07-18
Onelevenvy/flock,https://github.com/Onelevenvy/flock,218,"Flock is a workflow-based low-code platform for rapidly building chatbots, RAG, and coordinating multi-agent teams.ÔºàFlock ÊòØ‰∏Ä‰∏™Âü∫‰∫éworkflowÂ∑•‰ΩúÊµÅÁöÑ‰Ωé‰ª£Á†ÅÂπ≥Âè∞ÔºåÁî®‰∫éÂø´ÈÄüÊûÑÂª∫ËÅäÂ§©Êú∫Âô®‰∫∫„ÄÅRAG„ÄÅAgentÂíåMuti-AgentÂ∫îÁî®„ÄÇÔºâ",Apache License 2.0,0,0,0,0,2024-09-04
MODSetter/gpt-instagram,https://github.com/MODSetter/gpt-instagram,215,A GPT-based autonomous multi-agent AI in Next.js that research & recommends Instagram Viral Posts reflecting your personality.,The MIT License,0,0,0,0,2024-07-10
vladmeer/pumpfun-bundler,https://github.com/vladmeer/pumpfun-bundler,208,"PumpFun bundler, create/buy token in single bundle for Pumpfun",The MIT License,0,0,0,0,2024-07-28
matsuoka-601/waterball,https://github.com/matsuoka-601/waterball,203,Fluid simulation on a sphereüåè,The MIT License,0,0,0,0,2025-02-02
asendlabs/startstack,https://github.com/asendlabs/startstack,202,"The easiest way to get started with your next saas project (better-auth, shadcn, stripe, nextjs)",The MIT License,0,0,0,0,2024-12-01
javayhu/free-directory-boilerplate,https://github.com/javayhu/free-directory-boilerplate,198,The Open Source Directory Boilerplate,The MIT License,0,0,0,0,2024-12-22
RylanBot/melody-workshop,https://github.com/RylanBot/melody-workshop,196,üéµ Audio processing and mixing in the browser„ÄåÈü≥È¢ëÁºñËæëÂ∑•ÂÖ∑„Äç,The MIT License,0,0,0,0,2024-11-29
AlirezaHadjar/react-native-fast-confetti,https://github.com/AlirezaHadjar/react-native-fast-confetti,193,üèéÔ∏è The fastest confetti animation library in react native,The MIT License,0,0,0,0,2024-10-16
strlrd-29/hookcn,https://github.com/strlrd-29/hookcn,189,Copy paste react hooks inspired by shadcn/ui,The MIT License,0,0,0,0,2024-12-09
antfu/vscode-array-index-inlay,https://github.com/antfu/vscode-array-index-inlay,189,Show array index inlay hints for large arrays for VS Code,The MIT License,0,0,0,0,2024-08-15
assistant-ui/assistant-ui-stockbroker,https://github.com/assistant-ui/assistant-ui-stockbroker,186,,The MIT License,0,0,0,0,2024-09-10
CH563/fakemail,https://github.com/CH563/fakemail,185,üì™The free temporary email service powered by Cloudflare,The MIT License,0,0,0,0,2025-01-02
virgoone/next-money,https://github.com/virgoone/next-money,183,Flux AI Image generator,The MIT License,0,0,0,0,2024-07-11
nikhils4/ui-beats,https://github.com/nikhils4/ui-beats,181,"Level up your UI development with reusable components from UI Beats, crafted with React, Typescript, Tailwind CSS, and Framer Motion.",The MIT License,0,0,0,0,2024-07-08
matsuoka-601/webgpu-ocean,https://github.com/matsuoka-601/webgpu-ocean,181,A real-time 3D fluid simulation implemented in WebGPU,The MIT License,0,0,0,0,2024-12-15
EarthZetaOrg/solana-raydium-volume-bot,https://github.com/EarthZetaOrg/solana-raydium-volume-bot,181,"‚ú® Solana Raydium Volume Bot ‚ú® increases volume of the pool with raydium and meteora through endless swap of buy and sell transactions on solana, raydium & meteora volume bot v3",The MIT License,0,0,0,0,2024-11-28
Maliksidk19/shadcn-datetime-picker,https://github.com/Maliksidk19/shadcn-datetime-picker,177,Beautifully crafted datetime picker component using shadcn ui,The MIT License,0,0,0,0,2024-07-16
karthikmudunuri/saas-landing-page-template,https://github.com/karthikmudunuri/saas-landing-page-template,176,"Template for saas landing page with dark theme using Next.js 14, React, TailwindCSS, Framer motion",The MIT License,0,0,0,0,2024-07-24
kleneway/next-ai-starter,https://github.com/kleneway/next-ai-starter,175,Opinionated batteries-included starter kit optimized for building applications using AI coding tools,The MIT License,0,0,0,0,2025-02-05
MoncyDev/Portfolio-Website,https://github.com/MoncyDev/Portfolio-Website,172,My Portfolio Website Showcasing the website 3d interactions or experience and my work.,The MIT License,0,0,0,0,2025-01-15
Bortoom/solana-raydium-sniper,https://github.com/Bortoom/solana-raydium-sniper,172,"Snipping bot to catch the token launch on the Raydium Protocol and buy the mass of the token, finally make the profit by selling them.",The MIT License,0,0,0,0,2025-02-11
Luancss/pixel-patterns,https://github.com/Luancss/pixel-patterns,171,"Modern open source components snippets: copy, paste, ready-to-use",The MIT License,0,0,0,0,2024-08-10
veloplanner/map-matrix,https://github.com/veloplanner/map-matrix,167,MapMatrix - A React application for synchronized multi-view map comparison. Mostly generated by AI.,The MIT License,0,0,0,0,2024-11-17
PremPrakashCodes/payment-gateways,https://github.com/PremPrakashCodes/payment-gateways,164,"This project demonstrates the integration of multiple payment gateways, including Stripe, Razorpay, PayPal and Coinbase using Next.js 14. It showcases how to implement these popular payment solutions in a web application.",The MIT License,0,0,0,0,2024-07-29
Aslam97/react-fancy-switch,https://github.com/Aslam97/react-fancy-switch,163,React Fancy Switch,The MIT License,0,0,0,0,2024-07-11
w3cj/openfreemap-examples,https://github.com/w3cj/openfreemap-examples,163,"Examples for react, vue, svelte and vanilla js using OpenFreeMap.org tiles with MapLibre GL JS libraries.",The MIT License,0,0,0,0,2024-10-21
SukkaW/location-guard-ng,https://github.com/SukkaW/location-guard-ng,163,A UserScript that hide/spoof your geographic location from websites.,The MIT License,0,0,0,0,2024-09-10
neigebaie/shadcn-ui-tree-view,https://github.com/neigebaie/shadcn-ui-tree-view,160,"Shadcn-ui based tree view, with multi-selection, drag, and more!",The MIT License,0,0,0,0,2025-01-31
RhysSullivan/tenant-kit,https://github.com/RhysSullivan/tenant-kit,152,"A collection of documentation, components, and resources for building multi-tenant applications.",The MIT License,0,0,0,0,2024-07-06
EarthZetaOrg/solana-pump-fun-frontend,https://github.com/EarthZetaOrg/solana-pump-fun-frontend,150,"‚ú®‚ú®‚ú® Solana Pumpfun Frontend | pumpfun clone, pump.fun fork, pumpfun frontend interacting with pumpfun smart contract and backend",The MIT License,0,0,0,0,2025-01-31
pdsuwwz/chatgpt-vue3-light-mvp,https://github.com/pdsuwwz/chatgpt-vue3-light-mvp,150,"üí≠ ‰∏Ä‰∏™ÂèØ‰∫åÊ¨°ÂºÄÂèë Chat Bot ÂçïËΩÆÂØπËØù Web Á´Ø MVP ÂéüÂûãÊ®°Êùø, Âü∫‰∫é Vue 3, Vite 6, TypeScript, Naive UI, Pinia(v3), UnoCSS Á≠â‰∏ªÊµÅÊäÄÊúØÊûÑÂª∫, üß§ÁÆÄÂçïÈõÜÊàêÂ§ßÊ®°Âûã API, ÈááÁî®ÂçïËΩÆ AI ÈóÆÁ≠îÂØπËØùÊ®°Âºè, ÊØèÊ¨°ÊèêÈóÆÁã¨Á´ãÂìçÂ∫î, Êó†ÈúÄ‰∏ä‰∏ãÊñá, ÊîØÊåÅÊâìÂ≠óÊú∫ÊïàÊûúÊµÅÂºèËæìÂá∫, ÈõÜÊàê markdown-it È¢ÑËßà, üíº Êòì‰∫éÂÆöÂà∂ÂíåÂø´ÈÄüÊê≠Âª∫ Chat  Á±ªÂ§ßËØ≠Ë®ÄÊ®°Âûã‰∫ßÂìÅ (ÈôÑÁ§∫‰æãÊà™Âõæ)",The MIT License,0,0,0,0,2024-07-25
fullsoak/fullsoak,https://github.com/fullsoak/fullsoak,149,a no-build TypeScript fullstack SSR-first framework for developing fast web applications with a shallow learning curve,The MIT License,0,0,0,0,2025-01-06
pipijoe/xryder-web,https://github.com/pipijoe/xryder-web,149," A rapid development template for middle and backend UI based on vite, react, tailwindcss and shadcn. ‰∏Ä‰∏™Âü∫‰∫évite„ÄÅreact„ÄÅtailwindcssÂíåshadcnÁöÑ‰∏≠ÂêéÂè∞uiÂø´ÈÄüÂºÄÂèëÊ®°Êùø",The MIT License,0,0,0,0,2024-11-29
banggx/morgana-form,https://github.com/banggx/morgana-form,147,Ëé´ÁîòÂ®úÈóÆÂç∑Ë°®ÂçïÁºñËæëÂô®Ôºå‰Ωé‰ª£Á†ÅÂø´ÈÄüÊê≠Âª∫Ë°®ÂçïÔºåAIË°®ÂçïÁîüÊàêÔºåË°®ÂçïÊï∞ÊçÆÊêúÈõÜÁªüËÆ°,Apache License 2.0,0,0,0,0,2024-07-21
tzezar/datagrid,https://github.com/tzezar/datagrid,146,Powerful. Flexible. Developer-friendly. Made with Svelte 5.,The MIT License,0,0,0,0,2024-09-18
mjackson/file-storage,https://github.com/mjackson/file-storage,145,Key/value storage for JavaScript File objects,The MIT License,0,0,0,0,2024-08-21
davideast/dataprompt,https://github.com/davideast/dataprompt,144,Prompts with data superpowers,Apache License 2.0,0,0,0,0,2025-02-12
webjsx/webjsx,https://github.com/webjsx/webjsx,143,A library for building web applications with JSX and Web Components.,The MIT License,0,0,0,0,2024-09-12
daisuke-awaji/bedrock-engineer,https://github.com/daisuke-awaji/bedrock-engineer,142,"Bedrock Engineer is an AI assistant of software development tasks. This tool combines the capabilities of a large language model with practical file system operations, web search functionality.",MIT No Attribution,0,0,0,0,2024-08-27
dohooo/supazod,https://github.com/dohooo/supazod,142,Generate Zod schemas from Supabase CLI generated types,The MIT License,0,0,0,0,2024-11-17
Xe/praise-me,https://github.com/Xe/praise-me,141,Praise my GitHub profile!,The MIT License,0,0,0,0,2024-08-04
akshaynstack/reactai,https://github.com/akshaynstack/reactai,140,"Try out our Live version here, no need to add API keys, just select model and try it out",The MIT License,0,0,0,0,2024-11-28
dai-shi/react18-use,https://github.com/dai-shi/react18-use,139,React 19 use hook shim,The MIT License,0,0,0,0,2024-08-15
ImtiazMani/doctor-dok,https://github.com/ImtiazMani/doctor-dok,135,"Convert all your Blood Tests, MRI Scans, TK Scans, After Visit reports, Hospital Admission Reports to JSON, safely store in the cloud and discuss, annotate, translate it with AI.",The MIT License,0,0,0,0,2025-02-11
aurijs/jason,https://github.com/aurijs/jason,129,Slash database complexity away with jason.,The MIT License,0,0,0,0,2024-10-22
FoxDavoid/YT-Desktop-App,https://github.com/FoxDavoid/YT-Desktop-App,128,YouTube Music Desktop App bundled with plugins,The MIT License,0,0,0,0,2024-12-01
run-llama/llama-slides,https://github.com/run-llama/llama-slides,122,,The MIT License,0,0,0,0,2024-09-02
LHRUN/one-space,https://github.com/LHRUN/one-space,120,One Space is a personal space page dedicated to showing yourself,The MIT License,0,0,0,0,2024-09-23
turbostarter/extro,https://github.com/turbostarter/extro,116,Open source browser extension starter kit üß©,The MIT License,0,0,0,0,2024-10-30
osamaqarem/drag-select,https://github.com/osamaqarem/drag-select,115,"üëÜ A React Native utility for creating a pan gesture that auto-selects items in a list, like your favorite gallery app.",The MIT License,0,0,0,0,2024-11-16
nobruf/shadcn-next-workflows,https://github.com/nobruf/shadcn-next-workflows,114,"Interactive workflow builder using React Flows, Next.js, and Shadcnui. Create, connect, and validate custom nodes easily.",The MIT License,0,0,0,0,2024-10-09
bundui/components,https://github.com/bundui/components,113,A collection of components that you can copy and paste into your applications. Built with Tailwind CSS and Framer Motion. ,The MIT License,0,0,0,0,2024-08-15
clchinkc/stockchat,https://github.com/clchinkc/stockchat,111,"Personal project, Generative AI, Python, FastAPI, React, Docker/Docker Compose",The MIT License,0,0,0,0,2025-01-03
yuyinws/vitepress-plugin-group-icons,https://github.com/yuyinws/vitepress-plugin-group-icons,111,Enhance code blocks features for VitePress.,The MIT License,0,0,0,0,2024-08-09
epicweb-dev/test-server,https://github.com/epicweb-dev/test-server,109,Utility for creating HTTP and WebSocket servers for testing.,The MIT License,0,0,0,0,2024-08-22
TooonyChen/AuthInbox,https://github.com/TooonyChen/AuthInbox,109,"Auth Inbox üì¨ is a self-hosted, open-source platform for receiving multiple email verification codes and real-time notifications, built using Cloudflare's free services. | Auth Inbox üì¨ ÊòØ‰∏Ä‰∏™Ëá™Âª∫ÁöÑÂºÄÊ∫êÂ§öÈÇÆÁÆ±È™åËØÅÁ†ÅÁöÑÊé•Á†ÅÂπ≥Âè∞ÔºåÂü∫‰∫é Cloudflare ÁöÑÂÖçË¥πÊúçÂä°„ÄÇ",The MIT License,0,0,0,0,2024-10-07
mckaywrigley/o1-ai-playground,https://github.com/mckaywrigley/o1-ai-playground,108,,The MIT License,0,0,0,0,2024-09-13
ansh/deeperseeker-app,https://github.com/ansh/deeperseeker-app,107,,The MIT License,0,0,0,0,2025-01-27
Baoing/hooks,https://github.com/Baoing/hooks,105,"Lightweight, multi-application based React hooks library",The MIT License,0,0,0,0,2024-08-07
mindtown-ai/dynamic-prompt,https://github.com/mindtown-ai/dynamic-prompt,105,This component allows you to dynamically render text fields and select inputs based on the provided data.,The MIT License,0,0,0,0,2024-09-06
threepointone/durable-chat,https://github.com/threepointone/durable-chat,103,"Chat, with Durable Objects",The MIT License,0,0,0,0,2024-08-11
rudrodip/shadcn-chart-brush,https://github.com/rudrodip/shadcn-chart-brush,102,zoomable chart with brush made with shadcn charts / recharts,The MIT License,0,0,0,0,2024-08-10
procivis/one-wallet,https://github.com/procivis/one-wallet,102,"Digital wallet with eIDAS 2.0 compliancy, ISO 18013-5 mdocs, IETF SD-JWT VC, OID4VC, and W3C VCs. ",Apache License 2.0,0,0,0,0,2024-09-23
kratos-te/solana-ai-agent,https://github.com/kratos-te/solana-ai-agent,101,"Solana AI agent,  connect on Solana using langchain, blockahin ai agent",Apache License 2.0,0,0,0,0,2025-01-22
strlrd-29/shadcn-ui-form-builder,https://github.com/strlrd-29/shadcn-ui-form-builder,101,Shadcn/ui form builder.,The MIT License,0,0,0,0,2024-10-25
metros-org/orbit-framework,https://github.com/metros-org/orbit-framework,100,,The MIT License,0,0,0,0,2025-01-16
mapembert/bolt.new-any-llm,https://github.com/mapembert/bolt.new-any-llm,99,,The MIT License,0,0,0,0,2024-10-23
pierce-smith1/io7,https://github.com/pierce-smith1/io7,98,An in-depth look into the compression format used to store Windows 95/98's boot graphics,The MIT License,0,0,0,0,2024-07-14
yoyocharlie/nextMotion,https://github.com/yoyocharlie/nextMotion,98,,The MIT License,0,0,0,0,2024-09-12
animate-react-native/accordion,https://github.com/animate-react-native/accordion,97,"A React Native Accordion component, powered by React Native Reanimated layout animation that's capable of rendering and animating content that has a dynamic height.",The MIT License,0,0,0,0,2024-11-20
byigitt/visa-checker,https://github.com/byigitt/visa-checker,97,Schengen vizesi randevularƒ±nƒ± otomatik takip eden ve Telegram √ºzerinden bildirim g√∂nderen bot.,The MIT License,0,0,0,0,2024-11-27
hviana/faster_react,https://github.com/hviana/faster_react,96,"Tiny Full-Stack React framework. Avoid Overengineering. Automatic routes, reload and component bundle. It uses its own RSC engine, combining SSR and CSR. 100% Deno, no Node dependencies. Fully compatible with Deno Deploy and Serverless Environments.",The MIT License,0,0,0,0,2024-09-17
